"","slugSeason","slugTeam","typeSeason","locationGame","outcomeGame","fgm","fga","pctFG","fg3m","fg3a","pctFG3","fg2m","fg2a","pctFG2","oreb","dreb","treb","ast","stl","blk","tov","pf","minutes","games"
"1","2017-18","CLE","Regular Season","H","W",1212,2420,0.5,362,894,0.4,850,1526,0.6,222,1009,1231,726,217,99,382,490,7013,29
"2","2017-18","CLE","Regular Season","H","L",471,1063,0.4,99,369,0.3,372,694,0.5,119,389,508,268,72,49,161,232,2880,12
"3","2017-18","CLE","Regular Season","A","W",892,1805,0.5,298,712,0.4,594,1093,0.5,190,724,914,517,169,84,268,412,5045,21
"4","2017-18","CLE","Regular Season","A","L",736,1662,0.4,222,661,0.3,514,1001,0.5,163,639,802,405,124,80,280,390,4811,20
"5","2017-18","CLE","Playoffs","H","W",307,629,0.5,86,220,0.4,221,409,0.5,75,245,320,150,59,38,102,166,1919,8
"6","2017-18","CLE","Playoffs","H","L",100,257,0.4,25,92,0.3,75,165,0.5,41,96,137,62,18,13,40,63,724,3
"7","2017-18","CLE","Playoffs","A","W",157,330,0.5,46,130,0.4,111,200,0.6,28,137,165,82,16,19,31,76,984,4
"8","2017-18","CLE","Playoffs","A","L",247,585,0.4,64,225,0.3,183,360,0.5,71,217,288,129,38,27,90,125,1701,7
"9","2017-18","BOS","Regular Season","H","W",1077,2314,0.5,304,822,0.4,773,1492,0.5,259,1010,1269,667,200,143,331,539,6488,27
"10","2017-18","BOS","Regular Season","H","L",526,1212,0.4,162,441,0.4,364,771,0.5,123,458,581,321,91,72,192,294,3438,14
"11","2017-18","BOS","Regular Season","A","W",1076,2346,0.5,338,832,0.4,738,1514,0.5,261,1000,1261,608,211,121,392,521,6772,28
"12","2017-18","BOS","Regular Season","A","L",462,1103,0.4,135,397,0.3,327,706,0.5,124,410,534,246,102,37,176,264,3117,13
"13","2017-18","BOS","Playoffs","H","W",391,850,0.5,116,305,0.4,275,545,0.5,83,347,430,231,81,44,102,196,2424,10
"14","2017-18","BOS","Playoffs","H","L",29,85,0.3,7,39,0.2,22,46,0.5,11,31,42,18,6,0,5,20,240,1
"15","2017-18","BOS","Playoffs","A","W",41,91,0.5,10,38,0.3,31,53,0.6,9,40,49,19,9,7,13,20,263,1
"16","2017-18","BOS","Playoffs","A","L",231,556,0.4,66,199,0.3,165,357,0.5,65,206,271,135,34,26,85,152,1677,7
"17","2017-18","HOU","Regular Season","H","W",1359,2902,0.5,535,1483,0.4,824,1419,0.6,315,1213,1528,778,320,167,437,617,8229,34
"18","2017-18","HOU","Regular Season","H","L",249,572,0.4,99,293,0.3,150,279,0.5,66,225,291,141,46,26,108,178,1680,7
"19","2017-18","HOU","Regular Season","A","W",1225,2603,0.5,499,1297,0.4,726,1306,0.6,273,1081,1354,666,260,165,402,603,7443,31
"20","2017-18","HOU","Regular Season","A","L",341,829,0.4,123,397,0.3,218,432,0.5,85,306,391,182,73,34,133,199,2398,10
"21","2017-18","HOU","Playoffs","H","W",270,598,0.5,108,289,0.4,162,309,0.5,60,241,301,140,57,39,70,135,1684,7
"22","2017-18","HOU","Playoffs","H","L",113,270,0.4,30,118,0.3,83,152,0.5,35,100,135,57,29,13,32,61,719,3
"23","2017-18","HOU","Playoffs","A","W",149,343,0.4,49,155,0.3,100,188,0.5,30,147,177,73,37,31,37,76,960,4
"24","2017-18","HOU","Playoffs","A","L",100,239,0.4,41,114,0.4,59,125,0.5,24,94,118,50,15,10,50,53,720,3
"25","2017-18","GSW","Regular Season","H","W",1295,2478,0.5,345,831,0.4,950,1647,0.6,255,1047,1302,915,234,237,422,544,6960,29
"26","2017-18","GSW","Regular Season","H","L",471,986,0.5,117,305,0.4,354,681,0.5,108,373,481,327,89,81,203,235,2879,12
"27","2017-18","GSW","Regular Season","A","W",1307,2514,0.5,350,872,0.4,957,1642,0.6,226,1077,1303,884,237,208,414,576,7023,29
"28","2017-18","GSW","Regular Season","A","L",436,1001,0.4,114,361,0.3,322,640,0.5,102,380,482,276,96,86,190,252,2879,12
"29","2017-18","GSW","Playoffs","H","W",441,874,0.5,118,316,0.4,323,558,0.6,90,380,470,298,79,67,120,189,2418,10
"30","2017-18","GSW","Playoffs","H","L",35,89,0.4,9,27,0.3,26,62,0.4,16,33,49,14,6,3,16,24,240,1
"31","2017-18","GSW","Playoffs","A","W",250,504,0.5,73,201,0.4,177,303,0.6,39,205,244,155,50,41,64,119,1441,6
"32","2017-18","GSW","Playoffs","A","L",140,339,0.4,35,115,0.3,105,224,0.5,47,135,182,80,30,11,59,82,959,4
"33","2017-18","NOP","Regular Season","H","W",1087,2107,0.5,240,641,0.4,847,1466,0.6,217,882,1099,717,207,146,348,443,5834,24
"34","2017-18","NOP","Regular Season","H","L",696,1481,0.5,156,484,0.3,540,997,0.5,129,550,679,443,136,101,262,335,4107,17
"35","2017-18","NOP","Regular Season","A","W",1069,2192,0.5,270,702,0.4,799,1490,0.5,213,914,1127,640,216,140,327,463,5915,24
"36","2017-18","NOP","Regular Season","A","L",648,1461,0.4,171,485,0.4,477,976,0.5,153,577,730,395,98,98,245,329,4104,17
"37","2017-18","NOP","Playoffs","H","W",139,261,0.5,34,83,0.4,105,178,0.6,23,112,135,91,28,13,41,64,725,3
"38","2017-18","NOP","Playoffs","H","L",32,88,0.4,4,26,0.2,28,62,0.5,10,41,51,17,7,4,19,21,240,1
"39","2017-18","NOP","Playoffs","A","W",84,170,0.5,20,48,0.4,64,122,0.5,17,75,92,51,12,16,28,34,480,2
"40","2017-18","NOP","Playoffs","A","L",131,289,0.5,31,86,0.4,100,203,0.5,21,111,132,83,26,12,39,55,722,3
"41","2017-18","MEM","Regular Season","H","W",616,1325,0.5,172,441,0.4,444,884,0.5,172,529,701,369,137,90,219,372,3841,16
"42","2017-18","MEM","Regular Season","H","L",895,2095,0.4,218,688,0.3,677,1407,0.5,242,769,1011,547,181,135,360,574,6030,25
"43","2017-18","MEM","Regular Season","A","W",220,456,0.5,60,151,0.4,160,305,0.5,35,192,227,122,43,40,76,134,1440,6
"44","2017-18","MEM","Regular Season","A","L",1282,2912,0.4,308,872,0.4,974,2040,0.5,330,1054,1384,729,252,131,527,820,8409,35
"45","2017-18","PHI","Regular Season","H","W",1296,2661,0.5,336,878,0.4,960,1783,0.5,343,1162,1505,882,257,168,427,637,7202,30
"46","2017-18","PHI","Regular Season","H","L",435,978,0.4,105,349,0.3,330,629,0.5,122,380,502,271,96,64,186,247,2714,11
"47","2017-18","PHI","Regular Season","A","W",913,1869,0.5,243,643,0.4,670,1226,0.5,217,848,1065,611,184,108,346,485,5308,22
"48","2017-18","PHI","Regular Season","A","L",705,1590,0.4,217,575,0.4,488,1015,0.5,211,606,817,457,145,80,342,442,4563,19
"49","2017-18","PHI","Playoffs","H","W",117,270,0.4,32,82,0.4,85,188,0.5,42,114,156,85,22,9,33,66,721,3
"50","2017-18","PHI","Playoffs","H","L",78,193,0.4,16,66,0.2,62,127,0.5,30,69,99,45,15,10,28,40,505,2
"51","2017-18","PHI","Playoffs","A","W",77,165,0.5,25,65,0.4,52,100,0.5,23,75,98,50,22,10,36,51,478,2
"52","2017-18","PHI","Playoffs","A","L",115,257,0.4,26,80,0.3,89,177,0.5,39,103,142,78,19,12,39,71,721,3
"53","2017-18","WAS","Regular Season","H","W",988,1964,0.5,243,608,0.4,745,1356,0.5,228,815,1043,621,205,119,346,520,5577,23
"54","2017-18","WAS","Regular Season","H","L",677,1511,0.4,173,467,0.4,504,1044,0.5,189,588,777,413,114,71,271,367,4346,18
"55","2017-18","WAS","Regular Season","A","W",828,1713,0.5,208,543,0.4,620,1170,0.5,194,669,863,534,175,85,251,409,4848,20
"56","2017-18","WAS","Regular Season","A","L",782,1830,0.4,190,555,0.3,592,1275,0.5,212,641,853,497,151,78,284,450,5095,21
"57","2017-18","WAS","Playoffs","H","W",86,170,0.5,17,40,0.4,69,130,0.5,16,63,79,52,20,16,24,44,483,2
"58","2017-18","WAS","Playoffs","H","L",32,79,0.4,8,22,0.4,24,57,0.4,11,31,42,12,3,5,14,19,239,1
"59","2017-18","WAS","Playoffs","A","L",120,262,0.5,23,69,0.3,97,193,0.5,24,95,119,76,24,10,36,63,721,3
"60","2017-18","SAC","Regular Season","H","W",572,1221,0.5,127,335,0.4,445,886,0.5,129,493,622,326,117,70,179,266,3413,14
"61","2017-18","SAC","Regular Season","H","L",1050,2294,0.5,238,640,0.4,812,1654,0.5,252,828,1080,569,178,100,379,535,6488,27
"62","2017-18","SAC","Regular Season","A","W",537,1133,0.5,114,306,0.4,423,827,0.5,137,437,574,290,96,69,168,241,3141,13
"63","2017-18","SAC","Regular Season","A","L",1020,2415,0.4,259,686,0.4,761,1729,0.4,258,820,1078,583,252,101,357,597,6720,28
"64","2017-18","DAL","Regular Season","H","W",605,1257,0.5,189,459,0.4,416,798,0.5,124,561,685,352,107,72,163,301,3603,15
"65","2017-18","DAL","Regular Season","H","L",965,2284,0.4,294,884,0.3,671,1400,0.5,221,853,1074,592,180,85,309,512,6319,26
"66","2017-18","DAL","Regular Season","A","W",370,767,0.5,121,312,0.4,249,455,0.5,60,305,365,226,65,39,93,156,2163,9
"67","2017-18","DAL","Regular Season","A","L",1188,2734,0.4,363,1033,0.4,825,1701,0.5,261,998,1259,688,226,114,399,609,7735,32
"68","2017-18","ATL","Regular Season","H","W",657,1363,0.5,188,486,0.4,469,877,0.5,158,552,710,453,127,77,230,316,3848,16
"69","2017-18","ATL","Regular Season","H","L",920,2120,0.4,287,822,0.3,633,1298,0.5,199,797,996,593,177,98,362,476,6006,25
"70","2017-18","ATL","Regular Season","A","W",330,705,0.5,92,231,0.4,238,474,0.5,80,288,368,180,58,36,114,156,1918,8
"71","2017-18","ATL","Regular Season","A","L",1223,2827,0.4,350,1005,0.3,873,1822,0.5,306,1056,1362,720,276,137,522,658,7943,33
"72","2017-18","IND","Regular Season","H","W",1156,2332,0.5,286,707,0.4,870,1625,0.5,259,937,1196,669,255,127,349,507,6551,27
"73","2017-18","IND","Regular Season","H","L",531,1198,0.4,106,344,0.3,425,854,0.5,147,435,582,255,96,53,179,253,3362,14
"74","2017-18","IND","Regular Season","A","W",883,1773,0.5,189,473,0.4,694,1300,0.5,191,708,899,489,196,75,258,399,5039,21
"75","2017-18","IND","Regular Season","A","L",775,1780,0.4,160,486,0.3,615,1294,0.5,191,604,795,406,174,85,261,385,4796,20
"76","2017-18","IND","Playoffs","H","W",83,160,0.5,23,56,0.4,60,104,0.6,16,66,82,44,17,4,24,40,480,2
"77","2017-18","IND","Playoffs","H","L",40,93,0.4,12,33,0.4,28,60,0.5,11,36,47,25,7,5,8,19,240,1
"78","2017-18","IND","Playoffs","A","W",36,79,0.5,11,28,0.4,25,51,0.5,8,36,44,19,12,4,11,21,241,1
"79","2017-18","IND","Playoffs","A","L",111,229,0.5,22,73,0.3,89,156,0.6,22,85,107,60,21,6,42,73,718,3
"80","2017-18","BKN","Regular Season","H","W",591,1243,0.5,198,537,0.4,393,706,0.6,136,542,678,370,94,100,222,306,3602,15
"81","2017-18","BKN","Regular Season","H","L",953,2302,0.4,325,933,0.3,628,1369,0.5,261,873,1134,569,160,114,332,540,6314,26
"82","2017-18","BKN","Regular Season","A","W",519,1110,0.5,172,450,0.4,347,660,0.5,124,488,612,347,91,69,189,286,3144,13
"83","2017-18","BKN","Regular Season","A","L",1073,2459,0.4,346,1004,0.3,727,1455,0.5,271,949,1220,655,167,107,424,556,6798,28
"84","2017-18","DEN","Regular Season","H","W",1290,2669,0.5,367,962,0.4,923,1707,0.5,346,1089,1435,847,228,153,428,564,7492,31
"85","2017-18","DEN","Regular Season","H","L",394,856,0.5,97,300,0.3,297,556,0.5,109,328,437,261,85,51,166,192,2400,10
"86","2017-18","DEN","Regular Season","A","W",662,1281,0.5,181,430,0.4,481,851,0.6,127,513,640,390,112,82,202,275,3626,15
"87","2017-18","DEN","Regular Season","A","L",992,2296,0.4,295,844,0.3,697,1452,0.5,320,818,1138,561,202,118,378,502,6359,26
"88","2017-18","UTA","Regular Season","H","W",1129,2316,0.5,331,852,0.4,798,1464,0.5,255,1016,1271,668,254,141,373,566,6746,28
"89","2017-18","UTA","Regular Season","H","L",441,1062,0.4,108,396,0.3,333,666,0.5,115,407,522,224,109,67,199,250,3122,13
"90","2017-18","UTA","Regular Season","A","W",835,1692,0.5,242,577,0.4,593,1115,0.5,192,716,908,526,175,101,276,375,4820,20
"91","2017-18","UTA","Regular Season","A","L",734,1727,0.4,206,600,0.3,528,1127,0.5,178,668,846,421,170,111,307,417,5068,21
"92","2017-18","UTA","Playoffs","H","W",120,253,0.5,35,94,0.4,85,159,0.5,34,103,137,61,28,17,43,60,719,3
"93","2017-18","UTA","Playoffs","H","L",67,167,0.4,18,58,0.3,49,109,0.4,13,75,88,33,11,9,32,40,479,2
"94","2017-18","UTA","Playoffs","A","W",78,167,0.5,24,61,0.4,54,106,0.5,20,84,104,48,13,8,31,43,481,2
"95","2017-18","UTA","Playoffs","A","L",150,325,0.5,41,116,0.4,109,209,0.5,36,130,166,81,31,21,60,83,959,4
"96","2017-18","CHA","Regular Season","H","W",879,1819,0.5,250,604,0.4,629,1215,0.5,221,779,1000,497,152,116,290,376,5093,21
"97","2017-18","CHA","Regular Season","H","L",742,1733,0.4,158,511,0.3,584,1222,0.5,192,673,865,397,128,97,247,334,4828,20
"98","2017-18","CHA","Regular Season","A","W",636,1353,0.5,187,434,0.4,449,919,0.5,172,558,730,369,112,64,154,239,3598,15
"99","2017-18","CHA","Regular Season","A","L",940,2201,0.4,229,684,0.3,711,1517,0.5,242,891,1133,507,167,96,320,460,6264,26
"100","2017-18","DET","Regular Season","H","W",1041,2163,0.5,282,708,0.4,759,1455,0.5,247,909,1156,630,195,99,311,428,6031,25
"101","2017-18","DET","Regular Season","H","L",584,1378,0.4,170,488,0.3,414,890,0.5,153,536,689,343,96,60,211,296,3887,16
"102","2017-18","DET","Regular Season","A","W",582,1234,0.5,160,398,0.4,422,836,0.5,152,479,631,311,130,65,166,249,3360,14
"103","2017-18","DET","Regular Season","A","L",1001,2354,0.4,274,779,0.4,727,1575,0.5,278,832,1110,584,207,93,357,535,6530,27
"104","2017-18","MIA","Regular Season","H","W",1058,2233,0.5,309,808,0.4,749,1425,0.5,244,917,1161,628,220,158,334,500,6343,26
"105","2017-18","MIA","Regular Season","H","L",559,1280,0.4,138,435,0.3,421,845,0.5,158,460,618,281,89,58,215,302,3647,15
"106","2017-18","MIA","Regular Season","A","W",687,1487,0.5,212,543,0.4,475,944,0.5,157,657,814,402,130,121,238,366,4319,18
"107","2017-18","MIA","Regular Season","A","L",880,1997,0.4,244,720,0.3,636,1277,0.5,204,767,971,551,181,100,331,480,5622,23
"108","2017-18","MIA","Playoffs","H","L",74,167,0.4,23,52,0.4,51,115,0.4,18,60,78,47,25,13,34,62,480,2
"109","2017-18","MIA","Playoffs","A","W",40,82,0.5,9,25,0.4,31,57,0.5,11,35,46,23,8,7,15,27,239,1
"110","2017-18","MIA","Playoffs","A","L",69,165,0.4,22,61,0.4,47,104,0.5,19,62,81,49,11,12,27,57,478,2
"111","2017-18","ORL","Regular Season","H","W",702,1428,0.5,185,479,0.4,517,949,0.5,145,606,751,421,144,114,251,340,4130,17
"112","2017-18","ORL","Regular Season","H","L",890,2090,0.4,227,714,0.3,663,1376,0.5,232,790,1022,518,176,101,340,429,5764,24
"113","2017-18","ORL","Regular Season","A","W",322,678,0.5,95,241,0.4,227,437,0.5,68,285,353,201,61,42,112,157,1918,8
"114","2017-18","ORL","Regular Season","A","L",1268,2846,0.4,337,971,0.3,931,1875,0.5,277,1011,1288,781,241,143,440,653,7919,33
"115","2017-18","MIL","Regular Season","H","W",1005,2027,0.5,203,558,0.4,802,1469,0.5,215,801,1016,605,224,150,314,523,6001,25
"116","2017-18","MIL","Regular Season","H","L",617,1332,0.5,140,426,0.3,477,906,0.5,119,474,593,361,129,83,208,335,3865,16
"117","2017-18","MIL","Regular Season","A","W",800,1601,0.5,182,456,0.4,618,1145,0.5,173,647,820,471,187,104,249,394,4635,19
"118","2017-18","MIL","Regular Season","A","L",835,1847,0.5,193,584,0.3,642,1263,0.5,181,657,838,468,182,106,307,500,5335,22
"119","2017-18","MIL","Playoffs","H","W",121,227,0.5,34,82,0.4,87,145,0.6,16,105,121,71,21,29,27,67,720,3
"120","2017-18","MIL","Playoffs","A","L",153,321,0.5,33,98,0.3,120,223,0.5,23,126,149,83,25,18,61,93,982,4
"121","2017-18","POR","Regular Season","H","W",1133,2402,0.5,329,836,0.4,804,1566,0.5,282,1034,1316,608,194,143,378,518,6751,28
"122","2017-18","POR","Regular Season","H","L",487,1131,0.4,123,358,0.3,364,773,0.5,126,412,538,219,80,54,150,248,3127,13
"123","2017-18","POR","Regular Season","A","W",851,1869,0.5,209,536,0.4,642,1333,0.5,214,789,1003,397,147,126,256,417,5064,21
"124","2017-18","POR","Regular Season","A","L",751,1730,0.4,184,578,0.3,567,1152,0.5,213,658,871,375,152,100,283,416,4828,20
"125","2017-18","POR","Playoffs","H","L",78,189,0.4,24,71,0.3,54,118,0.5,28,69,97,37,15,10,28,35,481,2
"126","2017-18","POR","Playoffs","A","L",87,175,0.5,19,58,0.3,68,117,0.6,17,60,77,39,18,5,30,47,479,2
"127","2017-18","PHX","Regular Season","H","W",393,826,0.5,92,258,0.4,301,568,0.5,93,375,468,225,60,48,154,229,2401,10
"128","2017-18","PHX","Regular Season","H","L",1182,2765,0.4,277,888,0.3,905,1877,0.5,331,1016,1347,593,207,162,465,692,7460,31
"129","2017-18","PHX","Regular Season","A","W",451,936,0.5,120,289,0.4,331,647,0.5,111,425,536,266,78,60,158,228,2643,11
"130","2017-18","PHX","Regular Season","A","L",1127,2614,0.4,274,851,0.3,853,1763,0.5,307,960,1267,659,224,100,458,658,7202,30
"131","2017-18","SAS","Regular Season","H","W",1350,2798,0.5,308,809,0.4,1042,1989,0.5,332,1138,1470,784,259,195,395,561,7948,33
"132","2017-18","SAS","Regular Season","H","L",304,695,0.4,60,217,0.3,244,478,0.5,83,267,350,183,61,53,118,126,1921,8
"133","2017-18","SAS","Regular Season","A","W",541,1168,0.5,122,313,0.4,419,855,0.5,143,517,660,309,110,75,167,234,3360,14
"134","2017-18","SAS","Regular Season","A","L",1007,2338,0.4,206,638,0.3,801,1700,0.5,291,855,1146,592,198,137,360,487,6507,27
"135","2017-18","SAS","Playoffs","H","W",37,81,0.5,15,28,0.5,22,53,0.4,7,27,34,20,6,4,8,18,240,1
"136","2017-18","SAS","Playoffs","H","L",37,87,0.4,7,33,0.2,30,54,0.6,10,31,41,19,8,5,10,21,241,1
"137","2017-18","SAS","Playoffs","A","L",99,251,0.4,20,80,0.2,79,171,0.5,25,88,113,56,24,6,34,63,722,3
"138","2017-18","MIN","Regular Season","H","W",1279,2600,0.5,254,683,0.4,1025,1917,0.5,335,991,1326,740,252,137,341,537,7253,30
"139","2017-18","MIN","Regular Season","H","L",438,969,0.5,89,271,0.3,349,698,0.5,118,318,436,248,90,42,128,207,2669,11
"140","2017-18","MIN","Regular Season","A","W",709,1431,0.5,142,389,0.4,567,1042,0.5,173,571,744,396,158,76,218,308,4109,17
"141","2017-18","MIN","Regular Season","A","L",939,2063,0.5,173,502,0.3,766,1561,0.5,222,713,935,477,189,90,276,443,5786,24
"142","2017-18","MIN","Playoffs","H","W",45,90,0.5,15,27,0.6,30,63,0.5,8,33,41,29,9,3,7,16,240,1
"143","2017-18","MIN","Playoffs","H","L",39,84,0.5,8,22,0.4,31,62,0.5,10,38,48,23,4,1,16,22,239,1
"144","2017-18","MIN","Playoffs","A","L",106,239,0.4,22,60,0.4,84,179,0.5,25,112,137,60,12,12,37,53,720,3
"145","2017-18","OKC","Regular Season","H","W",1090,2275,0.5,278,769,0.4,812,1506,0.5,327,902,1229,583,254,149,391,546,6490,27
"146","2017-18","OKC","Regular Season","H","L",556,1276,0.4,147,451,0.3,409,825,0.5,187,439,626,274,112,62,183,272,3385,14
"147","2017-18","OKC","Regular Season","A","W",899,1921,0.5,265,670,0.4,634,1251,0.5,275,713,988,508,192,111,254,421,5166,21
"148","2017-18","OKC","Regular Season","A","L",726,1749,0.4,191,601,0.3,535,1148,0.5,235,617,852,385,185,90,274,414,4807,20
"149","2017-18","OKC","Playoffs","H","W",80,174,0.5,23,50,0.5,57,124,0.5,16,74,90,29,17,8,25,40,480,2
"150","2017-18","OKC","Playoffs","H","L",36,90,0.4,11,35,0.3,25,55,0.5,10,36,46,22,11,4,13,25,239,1
"151","2017-18","OKC","Playoffs","A","L",107,255,0.4,29,88,0.3,78,167,0.5,30,98,128,47,25,13,44,65,716,3
"152","2017-18","NYK","Regular Season","H","W",798,1618,0.5,194,466,0.4,604,1152,0.5,208,684,892,453,139,106,268,407,4586,19
"153","2017-18","NYK","Regular Season","H","L",899,1994,0.5,171,522,0.3,728,1472,0.5,240,731,971,484,151,96,307,448,5357,22
"154","2017-18","NYK","Regular Season","A","W",421,883,0.5,88,218,0.4,333,665,0.5,101,366,467,255,75,70,123,222,2399,10
"155","2017-18","NYK","Regular Season","A","L",1216,2698,0.5,220,708,0.3,996,1990,0.5,310,971,1281,720,187,149,467,605,7498,31
"156","2017-18","CHI","Regular Season","H","W",704,1478,0.5,207,521,0.4,497,957,0.5,140,609,749,436,135,66,213,306,4082,17
"157","2017-18","CHI","Regular Season","H","L",892,2167,0.4,271,787,0.3,621,1380,0.4,243,828,1071,565,183,85,311,448,5818,24
"158","2017-18","CHI","Regular Season","A","W",417,891,0.5,127,309,0.4,290,582,0.5,98,383,481,243,88,34,130,211,2474,10
"159","2017-18","CHI","Regular Season","A","L",1157,2749,0.4,301,932,0.3,856,1817,0.5,309,1052,1361,679,220,104,436,606,7495,31
"160","2017-18","TOR","Regular Season","H","W",1430,3025,0.5,426,1156,0.4,1004,1869,0.5,343,1211,1554,852,263,215,423,707,8206,34
"161","2017-18","TOR","Regular Season","H","L",284,621,0.5,67,197,0.3,217,424,0.5,72,213,285,155,42,50,84,150,1704,7
"162","2017-18","TOR","Regular Season","A","W",1054,2158,0.5,310,833,0.4,744,1325,0.6,238,883,1121,637,201,150,320,534,6049,25
"163","2017-18","TOR","Regular Season","A","L",615,1365,0.5,165,519,0.3,450,846,0.5,147,500,647,351,120,85,218,392,3863,16
"164","2017-18","TOR","Playoffs","H","W",124,246,0.5,40,90,0.4,84,156,0.5,20,101,121,76,20,20,41,63,719,3
"165","2017-18","TOR","Playoffs","H","L",83,172,0.5,21,58,0.4,62,114,0.5,20,65,85,52,4,8,24,46,505,2
"166","2017-18","TOR","Playoffs","A","W",40,90,0.4,7,25,0.3,33,65,0.5,16,31,47,18,8,6,6,20,240,1
"167","2017-18","TOR","Playoffs","A","L",142,315,0.5,36,94,0.4,106,221,0.5,38,110,148,72,25,27,66,97,957,4
"168","2017-18","LAL","Regular Season","H","W",862,1773,0.5,224,619,0.4,638,1154,0.6,198,802,1000,539,166,95,290,397,4847,20
"169","2017-18","LAL","Regular Season","H","L",807,1875,0.4,161,566,0.3,646,1309,0.5,244,735,979,463,157,103,330,431,5119,21
"170","2017-18","LAL","Regular Season","A","W",629,1341,0.5,190,466,0.4,439,875,0.5,151,562,713,357,110,71,215,334,3623,15
"171","2017-18","LAL","Regular Season","A","L",1040,2259,0.5,247,733,0.3,793,1526,0.5,283,828,1111,590,200,119,421,574,6315,26
"172","2017-18","LAC","Regular Season","H","W",907,1837,0.5,226,589,0.4,681,1248,0.5,201,793,994,519,184,106,308,439,5283,22
"173","2017-18","LAC","Regular Season","H","L",751,1647,0.5,148,474,0.3,603,1173,0.5,219,603,822,431,125,75,271,367,4565,19
"174","2017-18","LAC","Regular Season","A","W",851,1736,0.5,214,556,0.4,637,1180,0.5,201,704,905,476,165,98,265,374,4801,20
"175","2017-18","LAC","Regular Season","A","L",793,1784,0.4,189,577,0.3,604,1207,0.5,211,666,877,406,154,93,310,458,5066,21
"176","2018-19","CLE","Regular Season","H","W",553,1146,0.5,170,437,0.4,383,709,0.5,157,492,649,302,92,38,172,255,3119,13
"177","2018-19","CLE","Regular Season","H","L",1048,2451,0.4,277,808,0.3,771,1643,0.5,300,831,1131,566,182,55,369,586,6808,28
"178","2018-19","CLE","Regular Season","A","W",243,533,0.5,56,157,0.4,187,376,0.5,70,222,292,118,34,18,55,112,1438,6
"179","2018-19","CLE","Regular Season","A","L",1345,3054,0.4,344,986,0.3,1001,2068,0.5,352,1074,1426,712,226,84,440,689,8406,35
"180","2018-19","BOS","Regular Season","H","W",1256,2549,0.5,386,980,0.4,870,1569,0.6,284,1032,1316,813,253,159,387,572,6767,28
"181","2018-19","BOS","Regular Season","H","L",505,1179,0.4,133,444,0.3,372,735,0.5,138,435,573,312,112,61,151,245,3118,13
"182","2018-19","BOS","Regular Season","A","W",891,1889,0.5,275,717,0.4,616,1172,0.5,201,746,947,552,187,99,253,443,5092,21
"183","2018-19","BOS","Regular Season","A","L",799,1806,0.4,238,688,0.3,561,1118,0.5,181,636,817,478,154,116,228,410,4802,20
"184","2018-19","BOS","Playoffs","H","W",68,161,0.4,21,56,0.4,47,105,0.4,14,89,103,40,11,7,31,36,478,2
"185","2018-19","BOS","Playoffs","H","L",69,171,0.4,25,81,0.3,44,90,0.5,15,80,95,49,12,8,27,47,480,2
"186","2018-19","BOS","Playoffs","A","W",121,246,0.5,39,93,0.4,82,153,0.5,19,120,139,66,16,16,40,63,720,3
"187","2018-19","BOS","Playoffs","A","L",63,179,0.4,17,67,0.3,46,112,0.4,19,74,93,38,14,3,27,41,481,2
"188","2018-19","HOU","Regular Season","H","W",1246,2674,0.5,537,1427,0.4,709,1247,0.6,297,1044,1341,688,266,138,389,654,7462,31
"189","2018-19","HOU","Regular Season","H","L",374,915,0.4,152,477,0.3,222,438,0.5,120,289,409,199,87,63,126,227,2420,10
"190","2018-19","HOU","Regular Season","A","W",887,1906,0.5,368,987,0.4,519,919,0.6,223,727,950,495,213,119,272,477,5305,22
"191","2018-19","HOU","Regular Season","A","L",711,1668,0.4,266,830,0.3,445,838,0.5,196,553,749,359,134,85,251,445,4638,19
"192","2018-19","HOU","Playoffs","H","W",206,438,0.5,80,212,0.4,126,226,0.6,55,184,239,97,36,39,71,106,1224,5
"193","2018-19","HOU","Playoffs","H","L",42,89,0.5,17,39,0.4,25,50,0.5,12,28,40,21,9,1,15,22,240,1
"194","2018-19","HOU","Playoffs","A","W",33,86,0.4,15,45,0.3,18,41,0.4,9,43,52,19,11,4,13,25,240,1
"195","2018-19","HOU","Playoffs","A","L",128,309,0.4,60,174,0.3,68,135,0.5,30,111,141,64,38,12,61,85,959,4
"196","2018-19","GSW","Regular Season","H","W",1366,2685,0.5,435,1048,0.4,931,1637,0.6,302,1112,1414,940,237,213,405,661,7196,30
"197","2018-19","GSW","Regular Season","H","L",448,1001,0.4,106,382,0.3,342,619,0.6,100,375,475,318,83,70,176,225,2692,11
"198","2018-19","GSW","Regular Season","A","W",1227,2402,0.5,399,935,0.4,828,1467,0.6,250,1027,1277,827,224,165,364,562,6484,27
"199","2018-19","GSW","Regular Season","A","L",571,1273,0.4,147,459,0.3,424,814,0.5,145,476,621,328,81,77,183,309,3434,14
"200","2018-19","GSW","Playoffs","H","W",248,509,0.5,71,187,0.4,177,322,0.5,73,198,271,167,49,40,98,133,1441,6
"201","2018-19","GSW","Playoffs","H","L",193,420,0.5,57,161,0.4,136,259,0.5,54,148,202,141,41,24,77,121,1202,5
"202","2018-19","GSW","Playoffs","A","W",345,703,0.5,106,275,0.4,239,428,0.6,72,292,364,237,55,51,110,187,1944,8
"203","2018-19","GSW","Playoffs","A","L",118,263,0.4,34,97,0.4,84,166,0.5,24,92,116,80,18,10,35,70,744,3
"204","2018-19","NOP","Regular Season","H","W",886,1760,0.5,196,519,0.4,690,1241,0.6,225,697,922,549,166,113,262,394,4564,19
"205","2018-19","NOP","Regular Season","H","L",901,2029,0.4,218,710,0.3,683,1319,0.5,228,769,997,564,163,102,338,457,5300,22
"206","2018-19","NOP","Regular Season","A","W",657,1277,0.5,166,416,0.4,491,861,0.6,166,534,700,400,105,86,212,285,3386,14
"207","2018-19","NOP","Regular Season","A","L",1137,2497,0.5,262,804,0.3,875,1693,0.5,290,969,1259,703,176,140,376,596,6514,27
"208","2018-19","MEM","Regular Season","H","W",826,1770,0.5,222,616,0.4,604,1154,0.5,191,735,926,505,182,104,266,444,5094,21
"209","2018-19","MEM","Regular Season","H","L",749,1728,0.4,168,573,0.3,581,1155,0.5,201,633,834,468,165,118,252,437,4827,20
"210","2018-19","MEM","Regular Season","A","W",479,1033,0.5,137,344,0.4,342,689,0.5,105,417,522,302,103,63,134,268,2930,12
"211","2018-19","MEM","Regular Season","A","L",1059,2393,0.4,284,835,0.3,775,1558,0.5,226,918,1144,688,234,163,428,652,7045,29
"212","2018-19","PHI","Regular Season","H","W",1330,2742,0.5,350,902,0.4,980,1840,0.5,329,1225,1554,878,233,183,414,648,7470,31
"213","2018-19","PHI","Regular Season","H","L",405,841,0.5,112,304,0.4,293,537,0.5,91,306,397,265,67,43,152,230,2401,10
"214","2018-19","PHI","Regular Season","A","W",855,1767,0.5,235,609,0.4,620,1158,0.5,219,751,970,564,156,119,280,429,4820,20
"215","2018-19","PHI","Regular Season","A","L",817,1883,0.4,192,659,0.3,625,1224,0.5,253,743,996,500,150,87,340,438,5121,21
"216","2018-19","PHI","Playoffs","H","W",190,371,0.5,43,107,0.4,147,264,0.6,51,151,202,120,27,17,62,83,962,4
"217","2018-19","PHI","Playoffs","H","L",68,168,0.4,15,63,0.2,53,105,0.5,27,66,93,42,14,17,25,47,478,2
"218","2018-19","PHI","Playoffs","A","W",119,258,0.5,29,88,0.3,90,170,0.5,36,126,162,73,20,17,54,71,719,3
"219","2018-19","PHI","Playoffs","A","L",96,233,0.4,26,83,0.3,70,150,0.5,23,102,125,58,15,14,48,68,719,3
"220","2018-19","WAS","Regular Season","H","W",975,1965,0.5,256,693,0.4,719,1272,0.6,223,768,991,612,205,103,295,436,5377,22
"221","2018-19","WAS","Regular Season","H","L",794,1719,0.5,201,617,0.3,593,1102,0.5,189,595,784,482,129,106,259,406,4635,19
"222","2018-19","WAS","Regular Season","A","W",434,933,0.5,111,306,0.4,323,627,0.5,116,368,484,267,82,52,121,225,2424,10
"223","2018-19","WAS","Regular Season","A","L",1253,2770,0.5,362,1115,0.3,891,1655,0.5,266,948,1214,793,267,118,445,634,7486,31
"224","2018-19","SAC","Regular Season","H","W",1036,2214,0.5,289,753,0.4,747,1461,0.5,278,892,1170,625,208,118,303,472,5769,24
"225","2018-19","SAC","Regular Season","H","L",742,1628,0.5,183,496,0.4,559,1132,0.5,194,564,758,417,133,70,216,367,4136,17
"226","2018-19","SAC","Regular Season","A","W",666,1367,0.5,166,412,0.4,500,955,0.5,147,523,670,389,128,69,179,327,3607,15
"227","2018-19","SAC","Regular Season","A","L",1097,2428,0.5,289,794,0.4,808,1634,0.5,287,840,1127,652,210,106,360,585,6244,26
"228","2018-19","DAL","Regular Season","H","W",955,2034,0.5,308,836,0.4,647,1198,0.5,253,873,1126,587,185,115,341,476,5761,24
"229","2018-19","DAL","Regular Season","H","L",640,1492,0.4,204,661,0.3,436,831,0.5,193,559,752,385,99,69,228,339,4103,17
"230","2018-19","DAL","Regular Season","A","W",382,792,0.5,138,361,0.4,244,431,0.6,85,352,437,234,57,39,109,178,2190,9
"231","2018-19","DAL","Regular Season","A","L",1205,2804,0.4,372,1144,0.3,833,1660,0.5,301,1100,1401,712,192,128,439,657,7738,32
"232","2018-19","ATL","Regular Season","H","W",766,1620,0.5,251,651,0.4,515,969,0.5,201,650,851,506,120,112,248,393,4123,17
"233","2018-19","ATL","Regular Season","H","L",963,2188,0.4,290,898,0.3,673,1290,0.5,262,827,1089,591,174,120,397,594,5858,24
"234","2018-19","ATL","Regular Season","A","W",521,1079,0.5,177,429,0.4,344,650,0.5,162,423,585,335,106,58,211,274,2905,12
"235","2018-19","ATL","Regular Season","A","L",1142,2637,0.4,349,1056,0.3,793,1581,0.5,330,925,1255,686,275,129,507,671,6956,29
"236","2018-19","IND","Regular Season","H","W",1243,2517,0.5,310,756,0.4,933,1761,0.5,275,1061,1336,804,268,171,396,559,6957,29
"237","2018-19","IND","Regular Season","H","L",475,1074,0.4,96,311,0.3,379,763,0.5,102,389,491,289,80,52,141,213,2879,12
"238","2018-19","IND","Regular Season","A","W",846,1666,0.5,180,462,0.4,666,1204,0.6,176,605,781,525,189,85,237,361,4587,19
"239","2018-19","IND","Regular Season","A","L",826,1878,0.4,193,552,0.3,633,1326,0.5,209,711,920,510,176,96,316,461,5280,22
"240","2018-19","IND","Playoffs","H","L",70,169,0.4,21,58,0.4,49,111,0.4,19,64,83,38,14,6,21,44,479,2
"241","2018-19","IND","Playoffs","A","L",64,165,0.4,19,61,0.3,45,104,0.4,13,65,78,45,19,8,24,36,483,2
"242","2018-19","BKN","Regular Season","H","W",984,2086,0.5,306,829,0.4,678,1257,0.5,255,889,1144,585,167,93,334,489,5623,23
"243","2018-19","BKN","Regular Season","H","L",700,1604,0.4,217,645,0.3,483,959,0.5,200,616,816,404,100,67,266,413,4373,18
"244","2018-19","BKN","Regular Season","A","W",781,1705,0.5,257,694,0.4,524,1011,0.5,217,668,885,451,131,77,248,396,4663,19
"245","2018-19","BKN","Regular Season","A","L",836,1963,0.4,267,797,0.3,569,1166,0.5,228,746,974,514,141,102,333,465,5327,22
"246","2018-19","BKN","Playoffs","H","L",75,186,0.4,20,77,0.3,55,109,0.5,25,59,84,35,16,6,29,50,479,2
"247","2018-19","BKN","Playoffs","A","W",38,88,0.4,11,26,0.4,27,62,0.4,10,35,45,15,9,2,11,27,241,1
"248","2018-19","BKN","Playoffs","A","L",79,183,0.4,24,67,0.4,55,116,0.5,21,52,73,46,13,6,28,37,479,2
"249","2018-19","DEN","Regular Season","H","W",1498,3026,0.5,382,1059,0.4,1116,1967,0.6,397,1221,1618,985,267,141,429,689,8162,34
"250","2018-19","DEN","Regular Season","H","L",275,628,0.4,71,208,0.3,204,420,0.5,79,237,316,172,51,32,85,139,1677,7
"251","2018-19","DEN","Regular Season","A","W",837,1790,0.5,240,637,0.4,597,1153,0.5,255,710,965,557,145,89,257,381,4860,20
"252","2018-19","DEN","Regular Season","A","L",829,1940,0.4,210,667,0.3,619,1273,0.5,241,664,905,531,171,101,283,435,5041,21
"253","2018-19","DEN","Playoffs","H","W",202,425,0.5,46,130,0.4,156,295,0.5,44,195,239,123,28,27,44,105,1199,5
"254","2018-19","DEN","Playoffs","H","L",104,275,0.4,14,76,0.2,90,199,0.5,49,106,155,60,15,17,24,60,718,3
"255","2018-19","DEN","Playoffs","A","W",80,181,0.4,26,56,0.5,54,125,0.4,28,62,90,46,11,6,15,44,480,2
"256","2018-19","DEN","Playoffs","A","L",173,382,0.5,48,127,0.4,125,255,0.5,62,122,184,107,26,15,46,89,1063,4
"257","2018-19","UTA","Regular Season","H","W",1224,2511,0.5,391,1014,0.4,833,1497,0.6,295,1142,1437,799,220,182,417,615,6974,29
"258","2018-19","UTA","Regular Season","H","L",432,1039,0.4,136,439,0.3,296,600,0.5,137,396,533,289,98,64,179,243,2881,12
"259","2018-19","UTA","Regular Season","A","W",892,1771,0.5,260,689,0.4,632,1082,0.6,174,776,950,580,165,127,307,436,5042,21
"260","2018-19","UTA","Regular Season","A","L",766,1761,0.4,206,647,0.3,560,1114,0.5,214,667,881,465,180,110,307,434,4880,20
"261","2018-19","UTA","Playoffs","H","W",37,86,0.4,11,35,0.3,26,51,0.5,16,36,52,24,7,7,14,19,241,1
"262","2018-19","UTA","Playoffs","H","L",32,77,0.4,12,41,0.3,20,36,0.6,7,41,48,21,9,11,14,22,241,1
"263","2018-19","UTA","Playoffs","A","L",104,269,0.4,24,103,0.2,80,166,0.5,36,100,136,70,30,9,45,68,720,3
"264","2018-19","CHA","Regular Season","H","W",1051,2218,0.5,310,798,0.4,741,1420,0.5,249,904,1153,611,176,138,285,475,6027,25
"265","2018-19","CHA","Regular Season","H","L",627,1433,0.4,180,559,0.3,447,874,0.5,145,535,680,363,110,78,207,323,3888,16
"266","2018-19","CHA","Regular Season","A","W",603,1249,0.5,192,477,0.4,411,772,0.5,136,466,602,348,120,71,152,258,3363,14
"267","2018-19","CHA","Regular Season","A","L",1016,2462,0.4,295,949,0.3,721,1513,0.5,284,873,1157,583,185,118,312,494,6568,27
"268","2018-19","DET","Regular Season","H","W",1071,2284,0.5,319,852,0.4,752,1432,0.5,310,900,1210,631,177,112,328,546,6342,26
"269","2018-19","DET","Regular Season","H","L",557,1343,0.4,156,516,0.3,401,827,0.5,180,506,686,328,95,57,207,333,3624,15
"270","2018-19","DET","Regular Season","A","W",619,1329,0.5,225,567,0.4,394,762,0.5,155,530,685,350,109,70,181,334,3624,15
"271","2018-19","DET","Regular Season","A","L",938,2282,0.4,293,919,0.3,645,1363,0.5,291,816,1107,536,188,92,346,598,6271,26
"272","2018-19","DET","Playoffs","H","L",78,196,0.4,24,70,0.3,54,126,0.4,25,55,80,47,17,7,19,55,480,2
"273","2018-19","DET","Playoffs","A","L",72,191,0.4,20,63,0.3,52,128,0.4,18,71,89,45,12,9,21,42,481,2
"274","2018-19","MIA","Regular Season","H","W",776,1672,0.5,230,606,0.4,546,1066,0.5,222,736,958,477,136,115,227,377,4566,19
"275","2018-19","MIA","Regular Season","H","L",840,1927,0.4,230,696,0.3,610,1231,0.5,257,696,953,503,168,114,334,490,5286,22
"276","2018-19","MIA","Regular Season","A","W",825,1746,0.5,235,642,0.4,590,1104,0.5,224,737,961,500,160,113,286,424,4827,20
"277","2018-19","MIA","Regular Season","A","L",810,1873,0.4,233,714,0.3,577,1159,0.5,218,710,928,511,163,106,308,421,5064,21
"278","2018-19","ORL","Regular Season","H","W",1057,2203,0.5,291,771,0.4,766,1432,0.5,252,940,1192,648,175,145,334,469,6025,25
"279","2018-19","ORL","Regular Season","H","L",631,1425,0.4,173,521,0.3,458,904,0.5,164,531,695,383,93,83,220,284,3891,16
"280","2018-19","ORL","Regular Season","A","W",727,1531,0.5,206,553,0.4,521,978,0.5,169,626,795,487,115,101,181,300,4079,17
"281","2018-19","ORL","Regular Season","A","L",901,2148,0.4,267,788,0.3,634,1360,0.5,237,805,1042,577,160,116,301,473,5787,24
"282","2018-19","ORL","Playoffs","H","L",63,161,0.4,20,77,0.3,43,84,0.5,14,62,76,39,15,7,33,36,481,2
"283","2018-19","ORL","Playoffs","A","W",36,90,0.4,14,29,0.5,22,61,0.4,10,38,48,19,9,4,11,19,241,1
"284","2018-19","ORL","Playoffs","A","L",62,164,0.4,18,68,0.3,44,96,0.5,24,69,93,37,9,9,33,39,481,2
"285","2018-19","MIL","Regular Season","H","W",1478,3009,0.5,480,1271,0.4,998,1738,0.6,301,1384,1685,871,254,199,441,635,7923,33
"286","2018-19","MIL","Regular Season","H","L",325,719,0.5,93,320,0.3,232,399,0.6,74,297,371,197,58,39,110,150,1915,8
"287","2018-19","MIL","Regular Season","A","W",1196,2437,0.5,338,971,0.3,858,1466,0.6,224,1100,1324,735,206,177,344,538,6510,27
"288","2018-19","MIL","Regular Season","A","L",556,1306,0.4,194,572,0.3,362,734,0.5,163,535,698,333,97,71,192,285,3438,14
"289","2018-19","MIL","Playoffs","H","W",252,547,0.5,85,248,0.3,167,299,0.6,64,268,332,160,40,45,68,126,1443,6
"290","2018-19","MIL","Playoffs","H","L",69,173,0.4,23,70,0.3,46,103,0.4,15,82,97,45,8,4,21,33,478,2
"291","2018-19","MIL","Playoffs","A","W",171,348,0.5,47,140,0.3,124,208,0.6,41,164,205,99,23,28,54,94,958,4
"292","2018-19","MIL","Playoffs","A","L",105,257,0.4,37,113,0.3,68,144,0.5,32,113,145,71,29,19,43,74,772,3
"293","2018-19","POR","Regular Season","H","W",1417,2873,0.5,406,1018,0.4,1011,1855,0.5,376,1191,1567,787,213,161,407,623,7747,32
"294","2018-19","POR","Regular Season","H","L",368,854,0.4,83,308,0.3,285,546,0.5,117,327,444,188,58,45,123,188,2215,9
"295","2018-19","POR","Regular Season","A","W",906,1911,0.5,223,612,0.4,683,1299,0.5,249,784,1033,499,139,118,267,423,5090,21
"296","2018-19","POR","Regular Season","A","L",779,1789,0.4,192,582,0.3,587,1207,0.5,225,666,891,413,136,89,294,435,4801,20
"297","2018-19","POR","Playoffs","H","W",216,485,0.4,64,167,0.4,152,318,0.5,68,174,242,94,42,30,61,106,1303,5
"298","2018-19","POR","Playoffs","H","L",120,265,0.5,39,104,0.4,81,161,0.5,28,94,122,71,18,14,37,65,744,3
"299","2018-19","POR","Playoffs","A","W",111,268,0.4,28,90,0.3,83,178,0.5,27,124,151,50,20,21,26,75,722,3
"300","2018-19","POR","Playoffs","A","L",184,429,0.4,58,164,0.4,126,265,0.5,60,148,208,101,30,17,76,118,1202,5
"301","2018-19","PHX","Regular Season","H","W",501,1027,0.5,137,353,0.4,364,674,0.5,110,400,510,316,112,86,163,275,2906,12
"302","2018-19","PHX","Regular Season","H","L",1153,2526,0.5,276,843,0.3,877,1683,0.5,254,875,1129,688,264,130,436,677,7013,29
"303","2018-19","PHX","Regular Season","A","W",320,648,0.5,74,190,0.4,246,458,0.5,69,251,320,180,62,36,103,154,1729,7
"304","2018-19","PHX","Regular Season","A","L",1315,2963,0.4,303,1014,0.3,1012,1949,0.5,315,1037,1352,773,297,166,542,826,8237,34
"305","2018-19","SAS","Regular Season","H","W",1408,2821,0.5,341,778,0.4,1067,2043,0.5,261,1201,1462,832,213,156,368,550,7762,32
"306","2018-19","SAS","Regular Season","H","L",338,764,0.4,79,225,0.4,259,539,0.5,89,300,389,200,36,42,109,168,2160,9
"307","2018-19","SAS","Regular Season","A","W",716,1383,0.5,157,384,0.4,559,999,0.6,139,579,718,442,98,71,187,311,3857,16
"308","2018-19","SAS","Regular Season","A","L",1006,2280,0.4,235,684,0.3,771,1596,0.5,268,830,1098,539,154,117,305,458,6023,25
"309","2018-19","SAS","Playoffs","H","W",92,173,0.5,17,42,0.4,75,131,0.6,25,61,86,49,12,9,13,37,482,2
"310","2018-19","SAS","Playoffs","H","L",37,79,0.5,5,17,0.3,32,62,0.5,11,35,46,23,4,4,9,22,240,1
"311","2018-19","SAS","Playoffs","A","W",40,83,0.5,7,15,0.5,33,68,0.5,10,37,47,20,4,4,11,17,240,1
"312","2018-19","SAS","Playoffs","A","L",107,261,0.4,18,65,0.3,89,196,0.5,29,108,137,56,12,11,23,60,719,3
"313","2018-19","MIN","Regular Season","H","W",1091,2295,0.5,260,718,0.4,831,1577,0.5,294,913,1207,658,234,146,338,510,6077,25
"314","2018-19","MIN","Regular Season","H","L",638,1447,0.4,168,500,0.3,470,947,0.5,159,522,681,383,130,72,195,312,3888,16
"315","2018-19","MIN","Regular Season","A","W",459,999,0.5,119,317,0.4,340,682,0.5,134,374,508,270,97,57,127,219,2640,11
"316","2018-19","MIN","Regular Season","A","L",1225,2742,0.4,280,822,0.3,945,1920,0.5,336,941,1277,707,222,136,370,623,7225,30
"317","2018-19","OKC","Regular Season","H","W",1183,2513,0.5,320,825,0.4,863,1688,0.5,316,957,1273,689,303,131,354,580,6538,27
"318","2018-19","OKC","Regular Season","H","L",556,1332,0.4,155,504,0.3,401,828,0.5,190,481,671,300,83,77,201,315,3412,14
"319","2018-19","OKC","Regular Season","A","W",965,2042,0.5,251,676,0.4,714,1366,0.5,257,862,1119,512,201,123,301,495,5303,22
"320","2018-19","OKC","Regular Season","A","L",793,1819,0.4,206,672,0.3,587,1147,0.5,268,611,879,416,179,94,263,449,4613,19
"321","2018-19","OKC","Playoffs","H","W",37,77,0.5,15,29,0.5,22,48,0.5,8,29,37,27,6,5,15,24,239,1
"322","2018-19","OKC","Playoffs","H","L",33,88,0.4,15,40,0.4,18,48,0.4,6,38,44,23,7,4,14,22,241,1
"323","2018-19","OKC","Playoffs","A","L",119,265,0.4,22,88,0.2,97,177,0.5,37,98,135,63,20,18,47,75,719,3
"324","2018-19","NYK","Regular Season","H","W",392,795,0.5,123,283,0.4,269,512,0.5,93,325,418,208,56,58,122,193,2183,9
"325","2018-19","NYK","Regular Season","H","L",1192,2803,0.4,311,978,0.3,881,1825,0.5,340,1084,1424,647,203,148,450,662,7729,32
"326","2018-19","NYK","Regular Season","A","W",317,715,0.4,90,253,0.4,227,462,0.5,88,320,408,168,60,58,91,173,1944,8
"327","2018-19","NYK","Regular Season","A","L",1233,2928,0.4,299,907,0.3,934,2021,0.5,336,1082,1418,623,238,158,436,685,7926,33
"328","2018-19","CHI","Regular Season","H","W",381,764,0.5,83,210,0.4,298,554,0.5,83,318,401,221,62,34,122,183,2184,9
"329","2018-19","CHI","Regular Season","H","L",1242,2851,0.4,276,839,0.3,966,2012,0.5,295,1057,1352,706,227,122,412,626,7729,32
"330","2018-19","CHI","Regular Season","A","W",547,1130,0.5,132,349,0.4,415,781,0.5,106,504,610,290,116,69,185,281,3272,13
"331","2018-19","CHI","Regular Season","A","L",1096,2460,0.4,254,725,0.4,842,1735,0.5,234,920,1154,579,198,126,387,573,6726,28
"332","2018-19","TOR","Regular Season","H","W",1397,2873,0.5,405,1070,0.4,992,1803,0.6,303,1145,1448,850,292,189,403,668,7722,32
"333","2018-19","TOR","Regular Season","H","L",359,798,0.4,94,288,0.3,265,510,0.5,87,300,387,208,64,53,134,177,2160,9
"334","2018-19","TOR","Regular Season","A","W",1124,2285,0.5,350,890,0.4,774,1395,0.6,242,977,1219,699,232,130,356,561,6315,26
"335","2018-19","TOR","Regular Season","A","L",580,1349,0.4,166,523,0.3,414,826,0.5,154,498,652,328,92,65,200,318,3682,15
"336","2018-19","TOR","Playoffs","H","W",354,762,0.5,114,314,0.4,240,448,0.5,69,325,394,222,76,45,99,220,2210,9
"337","2018-19","TOR","Playoffs","H","L",146,357,0.4,41,143,0.3,105,214,0.5,43,130,173,79,28,15,50,82,958,4
"338","2018-19","TOR","Playoffs","A","W",263,572,0.5,90,233,0.4,173,339,0.5,56,238,294,164,61,32,81,149,1681,7
"339","2018-19","TOR","Playoffs","A","L",141,343,0.4,41,137,0.3,100,206,0.5,31,124,155,76,28,18,46,92,961,4
"340","2018-19","LAL","Regular Season","H","W",957,1950,0.5,240,664,0.4,717,1286,0.6,234,804,1038,588,176,122,351,435,5282,22
"341","2018-19","LAL","Regular Season","H","L",779,1730,0.5,166,588,0.3,613,1142,0.5,192,701,893,480,107,114,286,395,4584,19
"342","2018-19","LAL","Regular Season","A","W",680,1397,0.5,195,485,0.4,485,912,0.5,165,594,759,413,140,85,208,307,3645,15
"343","2018-19","LAL","Regular Season","A","L",1075,2348,0.5,246,804,0.3,829,1544,0.5,244,886,1130,615,195,119,401,564,6263,26
"344","2018-19","LAC","Regular Season","H","W",1170,2366,0.5,288,709,0.4,882,1657,0.5,282,983,1265,707,181,132,343,617,6343,26
"345","2018-19","LAC","Regular Season","H","L",582,1319,0.4,138,395,0.3,444,924,0.5,164,498,662,353,107,67,208,363,3624,15
"346","2018-19","LAC","Regular Season","A","W",923,1884,0.5,226,558,0.4,697,1326,0.5,192,824,1016,525,147,94,283,486,5310,22
"347","2018-19","LAC","Regular Season","A","L",709,1609,0.4,169,456,0.4,540,1153,0.5,158,631,789,385,126,92,298,447,4558,19
"348","2018-19","LAC","Playoffs","H","L",107,270,0.4,31,95,0.3,76,175,0.4,36,89,125,65,21,11,36,72,719,3
"349","2018-19","LAC","Playoffs","A","W",94,170,0.6,27,65,0.4,67,105,0.6,17,59,76,63,17,2,29,56,481,2
"350","2018-19","LAC","Playoffs","A","L",38,95,0.4,11,30,0.4,27,65,0.4,7,33,40,24,10,7,16,22,241,1
"351","2019-20","CLE","Regular Season","H","W",465,946,0.5,126,329,0.4,339,617,0.5,125,424,549,269,73,57,194,203,2690,11
"352","2019-20","CLE","Regular Season","H","L",1003,2234,0.4,301,831,0.4,702,1403,0.5,281,793,1074,591,177,72,353,441,6023,25
"353","2019-20","CLE","Regular Season","A","W",336,702,0.5,70,228,0.3,266,474,0.6,94,295,389,163,62,32,134,161,1970,8
"354","2019-20","CLE","Regular Season","A","L",815,1833,0.4,230,682,0.3,585,1151,0.5,204,660,864,477,135,50,341,383,5042,21
"355","2019-20","BOS","Regular Season","H","W",1128,2315,0.5,352,870,0.4,776,1445,0.5,260,948,1208,646,214,164,328,540,6316,26
"356","2019-20","BOS","Regular Season","H","L",384,914,0.4,114,370,0.3,270,544,0.5,105,319,424,224,84,51,133,208,2453,10
"357","2019-20","BOS","Regular Season","A","W",930,1968,0.5,290,764,0.4,640,1204,0.5,249,806,1055,505,188,130,281,481,5282,22
"358","2019-20","BOS","Regular Season","A","L",529,1251,0.4,149,483,0.3,380,768,0.5,154,476,630,280,109,61,205,324,3386,14
"359","2019-20","BOS","Playoffs","H","W",124,269,0.5,41,112,0.4,83,157,0.5,39,97,136,71,23,13,24,72,718,3
"360","2019-20","BOS","Playoffs","H","L",191,418,0.5,60,180,0.3,131,238,0.6,39,186,225,114,31,22,73,108,1273,5
"361","2019-20","BOS","Playoffs","A","W",259,576,0.4,81,241,0.3,178,335,0.5,46,274,320,146,50,40,98,154,1679,7
"362","2019-20","BOS","Playoffs","A","L",82,181,0.5,29,86,0.3,53,95,0.6,25,63,88,54,10,7,29,45,479,2
"363","2019-20","HOU","Regular Season","H","W",1009,2186,0.5,389,1082,0.4,620,1104,0.6,237,862,1099,533,223,130,317,512,5756,24
"364","2019-20","HOU","Regular Season","H","L",466,1103,0.4,152,539,0.3,314,564,0.6,119,429,548,264,86,69,169,266,2881,12
"365","2019-20","HOU","Regular Season","A","W",873,1805,0.5,354,907,0.4,519,898,0.6,196,687,883,430,184,110,285,424,4854,20
"366","2019-20","HOU","Regular Season","A","L",588,1418,0.4,231,733,0.3,357,685,0.5,152,506,658,330,134,62,250,364,3889,16
"367","2019-20","HOU","Playoffs","H","W",159,368,0.4,75,205,0.4,84,163,0.5,36,140,176,92,35,14,37,92,960,4
"368","2019-20","HOU","Playoffs","H","L",66,146,0.5,26,63,0.4,40,83,0.5,7,49,56,47,18,7,25,39,481,2
"369","2019-20","HOU","Playoffs","A","W",39,81,0.5,14,39,0.4,25,42,0.6,4,37,41,19,13,3,14,19,240,1
"370","2019-20","HOU","Playoffs","A","L",185,434,0.4,88,254,0.3,97,180,0.5,33,160,193,98,43,18,81,116,1228,5
"371","2019-20","GSW","Regular Season","H","W",319,690,0.5,82,238,0.3,237,452,0.5,80,297,377,215,67,40,109,152,1921,8
"372","2019-20","GSW","Regular Season","H","L",989,2266,0.4,283,843,0.3,706,1423,0.5,245,836,1081,677,206,103,403,549,6286,26
"373","2019-20","GSW","Regular Season","A","W",306,611,0.5,92,224,0.4,214,387,0.6,76,247,323,225,58,41,97,150,1685,7
"374","2019-20","GSW","Regular Season","A","L",896,2163,0.4,221,727,0.3,675,1436,0.5,246,758,1004,546,203,115,321,453,5835,24
"375","2019-20","NOP","Regular Season","H","W",660,1360,0.5,217,534,0.4,443,826,0.5,187,549,736,436,119,79,218,304,3623,15
"376","2019-20","NOP","Regular Season","H","L",875,1949,0.4,279,806,0.3,596,1143,0.5,237,730,967,555,154,104,326,444,5081,21
"377","2019-20","NOP","Regular Season","A","W",650,1338,0.5,231,557,0.4,419,781,0.5,157,576,733,424,125,81,266,304,3626,15
"378","2019-20","NOP","Regular Season","A","L",880,1951,0.5,255,759,0.3,625,1192,0.5,216,696,912,517,141,94,333,472,5086,21
"379","2019-20","MEM","Regular Season","H","W",906,1808,0.5,210,595,0.4,696,1213,0.6,211,771,982,593,163,135,288,396,4828,20
"380","2019-20","MEM","Regular Season","H","L",690,1549,0.4,181,546,0.3,509,1003,0.5,186,581,767,439,128,79,248,349,4078,17
"381","2019-20","MEM","Regular Season","A","W",621,1256,0.5,190,456,0.4,431,800,0.5,132,579,711,385,106,77,194,297,3363,14
"382","2019-20","MEM","Regular Season","A","L",889,2021,0.4,217,700,0.3,672,1321,0.5,225,712,937,548,179,107,335,504,5309,22
"383","2019-20","PHI","Regular Season","H","W",1319,2701,0.5,347,909,0.4,972,1792,0.5,323,1134,1457,837,252,175,411,608,7472,31
"384","2019-20","PHI","Regular Season","H","L",161,357,0.5,54,146,0.4,107,211,0.5,46,122,168,104,32,21,53,82,962,4
"385","2019-20","PHI","Regular Season","A","W",513,1052,0.5,146,390,0.4,367,662,0.6,113,424,537,341,107,81,173,264,2884,12
"386","2019-20","PHI","Regular Season","A","L",1007,2307,0.4,301,862,0.3,706,1445,0.5,282,873,1155,602,195,112,348,575,6287,26
"387","2019-20","PHI","Playoffs","H","L",63,177,0.4,18,73,0.2,45,104,0.4,28,68,96,26,13,12,20,44,479,2
"388","2019-20","PHI","Playoffs","A","L",70,159,0.4,14,48,0.3,56,111,0.5,21,67,88,44,7,6,27,45,480,2
"389","2019-20","WAS","Regular Season","H","W",692,1430,0.5,197,491,0.4,495,939,0.5,174,529,703,405,135,76,212,345,3840,16
"390","2019-20","WAS","Regular Season","H","L",800,1842,0.4,226,642,0.4,574,1200,0.5,196,654,850,469,146,73,268,467,4848,20
"391","2019-20","WAS","Regular Season","A","W",401,813,0.5,124,288,0.4,277,525,0.5,84,302,386,248,83,49,119,180,2161,9
"392","2019-20","WAS","Regular Season","A","L",1097,2459,0.4,317,924,0.3,780,1535,0.5,278,810,1088,679,210,111,376,642,6506,27
"393","2019-20","SAC","Regular Season","H","W",663,1380,0.5,213,523,0.4,450,857,0.5,148,512,660,372,137,72,226,356,3861,16
"394","2019-20","SAC","Regular Season","H","L",774,1704,0.5,217,663,0.3,557,1041,0.5,187,658,845,432,125,76,271,435,4640,19
"395","2019-20","SAC","Regular Season","A","W",617,1255,0.5,229,536,0.4,388,719,0.5,121,514,635,386,136,67,198,309,3626,15
"396","2019-20","SAC","Regular Season","A","L",889,2025,0.4,255,789,0.3,634,1236,0.5,239,688,927,523,158,78,295,495,5335,22
"397","2019-20","DAL","Regular Season","H","W",879,1808,0.5,317,798,0.4,562,1010,0.6,207,772,979,520,121,109,240,360,4856,20
"398","2019-20","DAL","Regular Season","H","L",708,1627,0.4,262,768,0.3,446,859,0.5,182,595,777,421,108,74,225,381,4421,18
"399","2019-20","DAL","Regular Season","A","W",998,2083,0.5,371,957,0.4,627,1126,0.6,243,878,1121,591,151,112,267,421,5548,23
"400","2019-20","DAL","Regular Season","A","L",539,1254,0.4,186,572,0.3,353,682,0.5,159,484,643,317,80,68,177,300,3359,14
"401","2019-20","DAL","Playoffs","H","W",52,104,0.5,13,36,0.4,39,68,0.6,11,43,54,20,7,5,11,24,265,1
"402","2019-20","DAL","Playoffs","H","L",82,177,0.5,28,80,0.3,54,97,0.6,15,69,84,47,10,5,21,39,480,2
"403","2019-20","DAL","Playoffs","A","W",44,88,0.5,13,29,0.4,31,59,0.5,8,41,49,25,5,4,9,29,240,1
"404","2019-20","DAL","Playoffs","A","L",75,166,0.5,27,80,0.3,48,86,0.6,12,60,72,37,17,8,34,43,478,2
"405","2019-20","ATL","Regular Season","H","W",629,1288,0.5,185,493,0.4,444,795,0.6,152,516,668,369,100,74,204,337,3467,14
"406","2019-20","ATL","Regular Season","H","L",789,1806,0.4,220,674,0.3,569,1132,0.5,195,651,846,465,148,106,325,466,4822,20
"407","2019-20","ATL","Regular Season","A","W",255,505,0.5,85,211,0.4,170,294,0.6,55,219,274,150,43,29,98,120,1438,6
"408","2019-20","ATL","Regular Season","A","L",1050,2468,0.4,315,1038,0.3,735,1430,0.5,259,851,1110,621,232,132,428,625,6544,27
"409","2019-20","IND","Regular Season","H","W",1089,2209,0.5,260,699,0.4,829,1510,0.5,234,884,1118,681,192,146,319,478,6075,25
"410","2019-20","IND","Regular Season","H","L",440,978,0.4,101,315,0.3,339,663,0.5,94,364,458,269,68,54,129,220,2642,11
"411","2019-20","IND","Regular Season","A","W",877,1763,0.5,210,531,0.4,667,1232,0.5,176,712,888,531,152,102,242,400,4801,20
"412","2019-20","IND","Regular Season","A","L",669,1507,0.4,172,501,0.3,497,1006,0.5,132,529,661,407,131,74,235,347,4102,17
"413","2019-20","IND","Playoffs","H","L",72,157,0.5,22,58,0.4,50,99,0.5,11,64,75,47,19,11,29,46,481,2
"414","2019-20","IND","Playoffs","A","L",74,164,0.5,26,70,0.4,48,94,0.5,12,59,71,43,18,11,29,47,481,2
"415","2019-20","BKN","Regular Season","H","W",849,1748,0.5,264,688,0.4,585,1060,0.6,210,791,1001,523,150,71,321,409,4803,20
"416","2019-20","BKN","Regular Season","H","L",620,1434,0.4,202,605,0.3,418,829,0.5,176,560,736,361,91,78,242,334,3887,16
"417","2019-20","BKN","Regular Season","A","W",615,1378,0.4,216,618,0.3,399,760,0.5,172,565,737,380,104,92,182,322,3673,15
"418","2019-20","BKN","Regular Season","A","L",824,1938,0.4,259,835,0.3,565,1103,0.5,208,767,975,497,119,82,301,445,5119,21
"419","2019-20","BKN","Playoffs","H","L",69,188,0.4,35,101,0.3,34,87,0.4,21,65,86,45,13,10,27,31,480,2
"420","2019-20","BKN","Playoffs","A","L",76,177,0.4,27,83,0.3,49,94,0.5,16,75,91,58,7,8,31,54,478,2
"421","2019-20","DEN","Regular Season","H","W",1122,2298,0.5,282,759,0.4,840,1539,0.5,270,923,1193,732,204,128,339,504,6319,26
"422","2019-20","DEN","Regular Season","H","L",454,996,0.5,100,344,0.3,354,652,0.5,127,343,470,295,82,38,122,245,2667,11
"423","2019-20","DEN","Regular Season","A","W",854,1792,0.5,249,631,0.4,605,1161,0.5,236,694,930,542,172,95,261,426,4874,20
"424","2019-20","DEN","Regular Season","A","L",639,1402,0.5,170,500,0.3,469,902,0.5,153,476,629,383,128,76,232,310,3893,16
"425","2019-20","DEN","Playoffs","H","W",203,410,0.5,69,161,0.4,134,249,0.5,36,174,210,118,37,20,62,97,1221,5
"426","2019-20","DEN","Playoffs","H","L",147,320,0.5,43,116,0.4,104,204,0.5,32,116,148,95,19,12,47,98,959,4
"427","2019-20","DEN","Playoffs","A","W",157,320,0.5,58,140,0.4,99,180,0.6,38,147,185,82,28,22,58,89,961,4
"428","2019-20","DEN","Playoffs","A","L",231,518,0.4,63,198,0.3,168,320,0.5,70,159,229,133,33,22,84,142,1438,6
"429","2019-20","UTA","Regular Season","H","W",974,1975,0.5,318,802,0.4,656,1173,0.6,224,878,1102,535,136,92,330,456,5522,23
"430","2019-20","UTA","Regular Season","H","L",442,1016,0.4,150,436,0.3,292,580,0.5,90,413,503,255,70,38,179,251,2878,12
"431","2019-20","UTA","Regular Season","A","W",868,1763,0.5,286,733,0.4,582,1030,0.6,198,761,959,486,123,90,287,409,5048,21
"432","2019-20","UTA","Regular Season","A","L",602,1376,0.4,209,566,0.4,393,810,0.5,144,525,669,339,109,72,249,352,3914,16
"433","2019-20","UTA","Playoffs","H","W",85,157,0.5,32,66,0.5,53,91,0.6,19,68,87,41,11,2,20,39,483,2
"434","2019-20","UTA","Playoffs","H","L",34,75,0.5,18,36,0.5,16,39,0.4,5,25,30,20,8,3,10,20,241,1
"435","2019-20","UTA","Playoffs","A","W",45,87,0.5,20,44,0.5,25,43,0.6,11,25,36,32,5,7,6,18,238,1
"436","2019-20","UTA","Playoffs","A","L",115,254,0.5,40,115,0.3,75,139,0.5,30,105,135,57,19,10,42,56,747,3
"437","2019-20","CHA","Regular Season","H","W",396,854,0.5,136,353,0.4,260,501,0.5,113,308,421,253,62,46,131,182,2423,10
"438","2019-20","CHA","Regular Season","H","L",775,1802,0.4,238,695,0.3,537,1107,0.5,230,665,895,498,137,93,322,405,5095,21
"439","2019-20","CHA","Regular Season","A","W",485,1088,0.4,165,438,0.4,320,650,0.5,161,460,621,295,84,52,179,221,3148,13
"440","2019-20","CHA","Regular Season","A","L",769,1842,0.4,246,745,0.3,523,1097,0.5,211,633,844,503,145,77,271,415,5095,21
"441","2019-20","DET","Regular Season","H","W",475,935,0.5,150,345,0.4,325,590,0.6,107,398,505,301,75,49,155,200,2669,11
"442","2019-20","DET","Regular Season","H","L",853,1896,0.4,253,732,0.3,600,1164,0.5,218,659,877,511,156,103,318,445,5360,22
"443","2019-20","DET","Regular Season","A","W",396,777,0.5,116,287,0.4,280,490,0.6,84,300,384,239,83,45,128,168,2162,9
"444","2019-20","DET","Regular Season","A","L",871,2050,0.4,272,793,0.3,599,1257,0.5,235,752,987,538,176,102,359,486,5789,24
"445","2019-20","MIA","Regular Season","H","W",1198,2438,0.5,422,1005,0.4,776,1433,0.5,255,1076,1331,796,213,126,407,564,7083,29
"446","2019-20","MIA","Regular Season","H","L",270,600,0.4,83,265,0.3,187,335,0.6,53,228,281,183,55,38,88,144,1675,7
"447","2019-20","MIA","Regular Season","A","W",606,1262,0.5,209,520,0.4,397,742,0.5,114,572,686,410,111,71,200,323,3675,15
"448","2019-20","MIA","Regular Season","A","L",806,1860,0.4,265,794,0.3,541,1066,0.5,198,743,941,503,168,97,323,470,5302,22
"449","2019-20","MIA","Playoffs","H","W",234,495,0.5,74,208,0.4,160,287,0.6,48,224,272,149,44,19,72,106,1441,6
"450","2019-20","MIA","Playoffs","H","L",140,329,0.4,50,151,0.3,90,178,0.5,34,129,163,97,25,16,52,81,984,4
"451","2019-20","MIA","Playoffs","A","W",305,653,0.5,115,289,0.4,190,364,0.5,64,258,322,198,67,35,106,163,1947,8
"452","2019-20","MIA","Playoffs","A","L",113,246,0.5,29,98,0.3,84,148,0.6,17,94,111,79,9,11,29,67,718,3
"453","2019-20","ORL","Regular Season","H","W",746,1572,0.5,216,571,0.4,530,1001,0.5,188,681,869,472,155,98,236,331,4348,18
"454","2019-20","ORL","Regular Season","H","L",617,1518,0.4,172,583,0.3,445,935,0.5,185,548,733,383,128,87,197,310,4082,17
"455","2019-20","ORL","Regular Season","A","W",661,1350,0.5,186,453,0.4,475,897,0.5,148,516,664,395,124,74,167,259,3606,15
"456","2019-20","ORL","Regular Season","A","L",847,2028,0.4,233,747,0.3,614,1281,0.5,230,753,983,497,192,137,289,436,5548,23
"457","2019-20","ORL","Playoffs","H","L",74,171,0.4,37,84,0.4,37,87,0.4,11,67,78,50,16,7,34,38,482,2
"458","2019-20","ORL","Playoffs","A","W",44,89,0.5,16,41,0.4,28,48,0.6,4,44,48,29,6,2,15,26,238,1
"459","2019-20","ORL","Playoffs","A","L",68,183,0.4,22,74,0.3,46,109,0.4,18,71,89,40,12,7,22,41,480,2
"460","2019-20","MIL","Regular Season","H","W",1337,2716,0.5,439,1154,0.4,898,1562,0.6,304,1275,1579,834,212,183,430,576,7198,30
"461","2019-20","MIL","Regular Season","H","L",203,466,0.4,71,229,0.3,132,237,0.6,45,203,248,133,30,24,76,109,1225,5
"462","2019-20","MIL","Regular Season","A","W",1140,2349,0.5,348,981,0.4,792,1368,0.6,226,1151,1377,661,211,167,392,483,6272,26
"463","2019-20","MIL","Regular Season","A","L",480,1107,0.4,149,476,0.3,331,631,0.5,116,454,570,261,73,55,171,263,2905,12
"464","2019-20","MIL","Playoffs","H","W",82,177,0.5,31,86,0.4,51,91,0.6,18,95,113,53,10,8,34,45,482,2
"465","2019-20","MIL","Playoffs","H","L",146,341,0.4,46,135,0.3,100,206,0.5,48,124,172,86,25,17,60,91,959,4
"466","2019-20","MIL","Playoffs","A","W",136,265,0.5,45,113,0.4,91,152,0.6,20,118,138,81,29,12,42,59,747,3
"467","2019-20","MIL","Playoffs","A","L",37,88,0.4,11,37,0.3,26,51,0.5,8,36,44,23,8,5,10,22,240,1
"468","2019-20","POR","Regular Season","H","W",920,1893,0.5,302,723,0.4,618,1170,0.5,215,825,1040,458,129,163,277,454,5110,21
"469","2019-20","POR","Regular Season","H","L",606,1361,0.4,187,520,0.4,419,841,0.5,149,500,649,291,92,80,196,314,3604,15
"470","2019-20","POR","Regular Season","A","W",614,1274,0.5,182,468,0.4,432,806,0.5,133,510,643,306,102,82,162,321,3364,14
"471","2019-20","POR","Regular Season","A","L",982,2221,0.4,281,814,0.3,701,1407,0.5,257,764,1021,470,142,126,285,517,5763,24
"472","2019-20","POR","Playoffs","H","L",79,184,0.4,24,63,0.4,55,121,0.5,24,56,80,37,16,6,28,52,481,2
"473","2019-20","POR","Playoffs","A","W",31,79,0.4,13,34,0.4,18,45,0.4,5,45,50,18,3,8,16,28,241,1
"474","2019-20","POR","Playoffs","A","L",78,178,0.4,21,56,0.4,57,122,0.5,20,64,84,34,18,4,36,45,480,2
"475","2019-20","PHX","Regular Season","H","W",742,1498,0.5,234,590,0.4,508,908,0.6,155,629,784,481,139,87,240,379,4075,17
"476","2019-20","PHX","Regular Season","H","L",865,1902,0.5,235,704,0.3,630,1198,0.5,193,738,931,576,138,84,323,466,5306,22
"477","2019-20","PHX","Regular Season","A","W",745,1533,0.5,203,524,0.4,542,1009,0.5,182,571,753,485,151,61,220,375,4100,17
"478","2019-20","PHX","Regular Season","A","L",654,1496,0.4,159,502,0.3,495,994,0.5,182,527,709,445,131,58,254,389,4114,17
"479","2019-20","SAS","Regular Season","H","W",857,1737,0.5,227,557,0.4,630,1180,0.5,179,724,903,529,149,105,257,357,4664,19
"480","2019-20","SAS","Regular Season","H","L",598,1325,0.5,147,418,0.4,451,907,0.5,137,518,655,360,99,98,193,301,3621,15
"481","2019-20","SAS","Regular Season","A","W",557,1143,0.5,143,365,0.4,414,778,0.5,118,491,609,318,110,71,160,256,3149,13
"482","2019-20","SAS","Regular Season","A","L",983,2145,0.5,243,681,0.4,740,1464,0.5,206,797,1003,544,160,116,258,463,5787,24
"483","2019-20","MIN","Regular Season","H","W",348,757,0.5,121,321,0.4,227,436,0.5,109,303,412,202,72,46,113,171,1972,8
"484","2019-20","MIN","Regular Season","H","L",926,2215,0.4,287,958,0.3,639,1257,0.5,262,821,1083,558,208,142,338,508,5817,24
"485","2019-20","MIN","Regular Season","A","W",488,1033,0.5,159,431,0.4,329,602,0.5,108,422,530,302,106,71,165,254,2720,11
"486","2019-20","MIN","Regular Season","A","L",824,1860,0.4,286,830,0.3,538,1030,0.5,196,647,843,463,169,103,327,437,5068,21
"487","2019-20","OKC","Regular Season","H","W",980,1936,0.5,250,653,0.4,730,1283,0.6,212,804,1016,522,171,126,316,446,5574,23
"488","2019-20","OKC","Regular Season","H","L",545,1213,0.4,157,455,0.3,388,758,0.5,101,461,562,312,96,59,176,275,3387,14
"489","2019-20","OKC","Regular Season","A","W",853,1792,0.5,220,619,0.4,633,1173,0.5,155,775,930,450,176,120,250,379,5088,21
"490","2019-20","OKC","Regular Season","A","L",501,1215,0.4,143,444,0.3,358,771,0.5,125,455,580,278,107,48,193,290,3387,14
"491","2019-20","OKC","Playoffs","H","W",121,267,0.5,37,109,0.3,84,158,0.5,26,125,151,53,24,9,48,53,742,3
"492","2019-20","OKC","Playoffs","A","L",136,331,0.4,47,147,0.3,89,184,0.5,37,161,198,72,13,19,64,67,959,4
"493","2019-20","NYK","Regular Season","H","W",492,1014,0.5,104,285,0.4,388,729,0.5,165,400,565,255,79,62,131,228,2644,11
"494","2019-20","NYK","Regular Season","H","L",823,1917,0.4,199,629,0.3,624,1288,0.5,248,732,980,479,164,106,328,499,5281,22
"495","2019-20","NYK","Regular Season","A","W",419,899,0.5,100,272,0.4,319,627,0.5,119,405,524,234,73,46,133,213,2473,10
"496","2019-20","NYK","Regular Season","A","L",904,2066,0.4,228,686,0.3,676,1380,0.5,263,737,1000,488,188,99,322,524,5581,23
"497","2019-20","CHI","Regular Season","H","W",592,1212,0.5,183,456,0.4,409,756,0.5,148,480,628,347,145,72,226,312,3363,14
"498","2019-20","CHI","Regular Season","H","L",748,1808,0.4,225,721,0.3,523,1087,0.5,230,618,848,445,192,79,299,435,4807,20
"499","2019-20","CHI","Regular Season","A","W",325,687,0.5,115,299,0.4,210,388,0.5,70,262,332,185,90,37,117,165,1947,8
"500","2019-20","CHI","Regular Season","A","L",908,2055,0.4,270,806,0.3,638,1249,0.5,232,681,913,533,225,77,309,505,5570,23
"501","2019-20","TOR","Regular Season","H","W",1129,2292,0.5,385,933,0.4,744,1359,0.5,239,971,1210,709,240,126,363,563,6277,26
"502","2019-20","TOR","Regular Season","H","L",354,897,0.4,124,404,0.3,230,493,0.5,108,346,454,222,84,51,139,211,2422,10
"503","2019-20","TOR","Regular Season","A","W",1088,2356,0.5,374,987,0.4,714,1369,0.5,262,956,1218,677,251,133,376,591,6515,27
"504","2019-20","TOR","Regular Season","A","L",326,786,0.4,112,339,0.3,214,447,0.5,76,310,386,208,61,48,133,194,2187,9
"505","2019-20","TOR","Playoffs","H","W",78,172,0.5,31,79,0.4,47,93,0.5,17,74,91,48,11,12,19,43,477,2
"506","2019-20","TOR","Playoffs","H","L",131,334,0.4,41,148,0.3,90,186,0.5,31,130,161,83,29,20,57,90,962,4
"507","2019-20","TOR","Playoffs","A","W",221,467,0.5,89,216,0.4,132,251,0.5,42,197,239,142,38,28,61,114,1248,5
"508","2019-20","LAL","Regular Season","H","W",1072,2189,0.5,278,769,0.4,794,1420,0.6,270,898,1168,659,224,178,362,513,5987,25
"509","2019-20","LAL","Regular Season","H","L",416,917,0.5,109,344,0.3,307,573,0.5,123,347,470,263,72,57,152,205,2396,10
"510","2019-20","LAL","Regular Season","A","W",1185,2396,0.5,315,840,0.4,870,1556,0.6,268,972,1240,683,249,178,376,571,6534,27
"511","2019-20","LAL","Regular Season","A","L",333,767,0.4,80,289,0.3,253,478,0.5,96,273,369,198,67,55,151,182,2162,9
"512","2019-20","LAL","Playoffs","H","W",388,761,0.5,123,309,0.4,265,452,0.6,89,312,401,246,74,52,133,212,2161,9
"513","2019-20","LAL","Playoffs","H","L",107,262,0.4,30,108,0.3,77,154,0.5,39,98,137,61,29,18,39,64,720,3
"514","2019-20","LAL","Playoffs","A","W",290,579,0.5,81,233,0.3,209,346,0.6,79,241,320,181,47,37,96,152,1682,7
"515","2019-20","LAL","Playoffs","A","L",77,162,0.5,20,68,0.3,57,94,0.6,15,53,68,50,19,5,35,48,481,2
"516","2019-20","LAC","Regular Season","H","W",1157,2413,0.5,365,937,0.4,792,1476,0.5,301,1068,1369,687,203,153,387,588,6532,27
"517","2019-20","LAC","Regular Season","H","L",354,823,0.4,99,295,0.3,255,528,0.5,108,301,409,188,54,34,126,195,2161,9
"518","2019-20","LAC","Regular Season","A","W",944,1964,0.5,288,770,0.4,656,1194,0.5,237,808,1045,541,170,80,274,495,5284,22
"519","2019-20","LAC","Regular Season","A","L",537,1225,0.4,143,408,0.4,394,817,0.5,121,487,608,292,84,71,212,316,3407,14
"520","2019-20","LAC","Playoffs","H","W",146,263,0.6,45,97,0.5,101,166,0.6,28,111,139,69,24,10,40,74,715,3
"521","2019-20","LAC","Playoffs","H","L",144,350,0.4,44,143,0.3,100,207,0.5,50,127,177,79,27,14,51,88,959,4
"522","2019-20","LAC","Playoffs","A","W",165,335,0.5,44,122,0.4,121,213,0.6,28,150,178,88,29,15,46,91,963,4
"523","2019-20","LAC","Playoffs","A","L",77,175,0.4,24,65,0.4,53,110,0.5,17,61,78,39,17,9,22,45,505,2
"524","2020-21","CLE","Regular Season","H","W",557,1106,0.5,160,368,0.4,397,738,0.5,131,482,613,352,106,77,201,242,3174,13
"525","2020-21","CLE","Regular Season","H","L",867,1992,0.4,235,713,0.3,632,1279,0.5,249,685,934,544,184,93,334,395,5553,23
"526","2020-21","CLE","Regular Season","A","W",371,787,0.5,100,274,0.4,271,513,0.5,85,333,418,238,83,39,121,166,2235,9
"527","2020-21","CLE","Regular Season","A","L",983,2290,0.4,225,786,0.3,758,1504,0.5,286,827,1113,582,186,116,383,505,6481,27
"528","2020-21","BOS","Regular Season","H","W",916,1858,0.5,329,806,0.4,587,1052,0.6,243,733,976,543,175,115,298,425,5091,21
"529","2020-21","BOS","Regular Season","H","L",588,1312,0.4,173,524,0.3,415,788,0.5,142,464,606,340,123,68,215,326,3594,15
"530","2020-21","BOS","Regular Season","A","W",662,1340,0.5,222,529,0.4,440,811,0.5,151,557,708,378,101,80,194,305,3601,15
"531","2020-21","BOS","Regular Season","A","L",819,1891,0.4,255,759,0.3,564,1132,0.5,229,667,896,428,157,120,257,415,5087,21
"532","2020-21","BOS","Playoffs","H","W",45,89,0.5,16,39,0.4,29,50,0.6,13,33,46,21,5,3,13,25,240,1
"533","2020-21","BOS","Playoffs","H","L",37,84,0.4,14,40,0.3,23,44,0.5,11,23,34,24,8,4,10,21,241,1
"534","2020-21","BOS","Playoffs","A","L",110,268,0.4,34,104,0.3,76,164,0.5,39,88,127,60,19,28,38,59,722,3
"535","2020-21","HOU","Regular Season","H","W",381,798,0.5,143,371,0.4,238,427,0.6,85,337,422,212,71,57,119,165,2160,9
"536","2020-21","HOU","Regular Season","H","L",993,2368,0.4,321,1057,0.3,672,1311,0.5,256,865,1121,585,208,119,383,526,6478,27
"537","2020-21","HOU","Regular Season","A","W",353,722,0.5,144,327,0.4,209,395,0.5,82,293,375,220,56,50,116,180,1924,8
"538","2020-21","HOU","Regular Season","A","L",1099,2484,0.4,384,1168,0.3,715,1316,0.5,248,901,1149,682,211,135,407,536,6742,28
"539","2020-21","GSW","Regular Season","H","W",1119,2212,0.5,407,989,0.4,712,1223,0.6,220,906,1126,764,196,114,369,510,6027,25
"540","2020-21","GSW","Regular Season","H","L",403,926,0.4,121,381,0.3,282,545,0.5,79,350,429,278,89,53,153,240,2641,11
"541","2020-21","GSW","Regular Season","A","W",600,1235,0.5,222,565,0.4,378,670,0.6,95,507,602,410,128,79,191,310,3358,14
"542","2020-21","GSW","Regular Season","A","L",851,1974,0.4,298,854,0.3,553,1120,0.5,180,761,941,539,174,96,341,466,5283,22
"543","2020-21","NOP","Regular Season","H","W",797,1606,0.5,200,525,0.4,597,1081,0.6,203,702,905,481,131,90,215,314,4348,18
"544","2020-21","NOP","Regular Season","H","L",740,1590,0.5,171,539,0.3,569,1051,0.5,197,614,811,464,133,76,270,315,4373,18
"545","2020-21","NOP","Regular Season","A","W",583,1146,0.5,165,413,0.4,418,733,0.6,167,495,662,365,115,66,212,238,3143,13
"546","2020-21","NOP","Regular Season","A","L",940,2070,0.5,226,713,0.3,714,1357,0.5,278,757,1035,562,166,83,306,428,5569,23
"547","2020-21","MEM","Regular Season","H","W",776,1661,0.5,209,568,0.4,567,1093,0.5,210,681,891,511,164,102,218,330,4346,18
"548","2020-21","MEM","Regular Season","H","L",715,1646,0.4,184,559,0.3,531,1087,0.5,209,596,805,443,157,87,226,310,4325,18
"549","2020-21","MEM","Regular Season","A","W",936,1835,0.5,254,643,0.4,682,1192,0.6,203,757,960,587,190,107,258,386,4833,20
"550","2020-21","MEM","Regular Season","A","L",658,1466,0.4,156,488,0.3,502,978,0.5,181,509,690,397,144,68,214,323,3920,16
"551","2020-21","MEM","Playoffs","H","L",86,192,0.4,23,76,0.3,63,116,0.5,23,69,92,49,15,5,18,43,481,2
"552","2020-21","MEM","Playoffs","A","W",45,100,0.4,7,20,0.3,38,80,0.5,16,26,42,18,12,5,9,23,240,1
"553","2020-21","MEM","Playoffs","A","L",90,180,0.5,22,62,0.4,68,118,0.6,17,55,72,43,13,10,25,37,478,2
"554","2020-21","PHI","Regular Season","H","W",1270,2544,0.5,366,908,0.4,904,1636,0.6,282,1039,1321,769,287,186,387,604,7021,29
"555","2020-21","PHI","Regular Season","H","L",276,634,0.4,75,222,0.3,201,412,0.5,89,237,326,168,57,43,112,142,1730,7
"556","2020-21","PHI","Regular Season","A","W",829,1729,0.5,227,582,0.4,602,1147,0.5,213,733,946,440,188,138,271,389,4847,20
"557","2020-21","PHI","Regular Season","A","L",606,1350,0.4,143,457,0.3,463,893,0.5,138,513,651,329,123,80,219,321,3845,16
"558","2020-21","PHI","Playoffs","H","W",184,352,0.5,40,106,0.4,144,246,0.6,35,127,162,110,39,33,37,82,963,4
"559","2020-21","PHI","Playoffs","H","L",114,237,0.5,32,87,0.4,82,150,0.5,22,111,133,71,26,15,51,71,722,3
"560","2020-21","PHI","Playoffs","A","W",135,259,0.5,39,83,0.5,96,176,0.5,31,107,138,74,22,14,36,75,719,3
"561","2020-21","PHI","Playoffs","A","L",77,181,0.4,23,65,0.4,54,116,0.5,20,83,103,44,9,12,23,48,479,2
"562","2020-21","WAS","Regular Season","H","W",876,1757,0.5,186,508,0.4,690,1249,0.6,192,717,909,504,155,85,254,417,4587,19
"563","2020-21","WAS","Regular Season","H","L",717,1542,0.5,180,559,0.3,537,983,0.5,154,577,731,415,104,58,238,378,4103,17
"564","2020-21","WAS","Regular Season","A","W",666,1377,0.5,160,416,0.4,506,961,0.5,159,561,720,405,122,60,219,310,3669,15
"565","2020-21","WAS","Regular Season","A","L",849,1871,0.5,207,605,0.3,642,1266,0.5,192,702,894,511,147,94,292,450,5031,21
"566","2020-21","WAS","Playoffs","H","W",40,88,0.5,9,24,0.4,31,64,0.5,13,44,57,24,8,12,13,27,240,1
"567","2020-21","WAS","Playoffs","H","L",38,96,0.4,8,35,0.2,30,61,0.5,13,28,41,18,5,3,8,18,239,1
"568","2020-21","WAS","Playoffs","A","L",125,259,0.5,18,62,0.3,107,197,0.5,27,92,119,70,11,9,43,75,723,3
"569","2020-21","SAC","Regular Season","H","W",704,1380,0.5,213,524,0.4,491,856,0.6,148,549,697,418,110,97,200,290,3840,16
"570","2020-21","SAC","Regular Season","H","L",851,1762,0.5,240,664,0.4,611,1098,0.6,149,585,734,523,153,91,266,387,4812,20
"571","2020-21","SAC","Regular Season","A","W",642,1337,0.5,178,493,0.4,464,844,0.5,165,513,678,394,116,83,202,301,3628,15
"572","2020-21","SAC","Regular Season","A","L",870,1903,0.5,243,719,0.3,627,1184,0.5,212,660,872,501,164,87,256,422,5049,21
"573","2020-21","DAL","Regular Season","H","W",868,1811,0.5,320,808,0.4,548,1003,0.5,186,764,950,496,120,76,247,406,5035,21
"574","2020-21","DAL","Regular Season","H","L",583,1299,0.4,173,564,0.3,410,735,0.6,149,453,602,309,100,69,197,304,3599,15
"575","2020-21","DAL","Regular Season","A","W",931,1882,0.5,318,823,0.4,613,1059,0.6,191,782,973,521,146,98,210,393,5067,21
"576","2020-21","DAL","Regular Season","A","L",576,1295,0.4,183,549,0.3,393,746,0.5,131,464,595,321,84,68,169,293,3602,15
"577","2020-21","DAL","Playoffs","H","L",106,264,0.4,36,103,0.3,70,161,0.4,31,85,116,55,16,5,27,58,721,3
"578","2020-21","DAL","Playoffs","A","W",123,247,0.5,49,106,0.5,74,141,0.5,25,96,121,68,19,9,31,63,720,3
"579","2020-21","DAL","Playoffs","A","L",45,91,0.5,10,36,0.3,35,55,0.6,16,31,47,22,4,1,14,21,239,1
"580","2020-21","ATL","Regular Season","H","W",1053,2137,0.5,333,819,0.4,720,1318,0.5,252,964,1216,615,175,134,318,470,6029,25
"581","2020-21","ATL","Regular Season","H","L",436,995,0.4,119,359,0.3,317,636,0.5,122,351,473,283,69,38,139,215,2667,11
"582","2020-21","ATL","Regular Season","A","W",662,1378,0.5,226,558,0.4,436,820,0.5,157,583,740,389,114,88,218,336,3886,16
"583","2020-21","ATL","Regular Season","A","L",786,1771,0.4,217,666,0.3,569,1105,0.5,229,627,856,450,145,82,239,371,4822,20
"584","2020-21","ATL","Playoffs","H","W",158,349,0.5,56,144,0.4,102,205,0.5,33,149,182,102,22,15,36,85,961,4
"585","2020-21","ATL","Playoffs","H","L",154,350,0.4,43,123,0.3,111,227,0.5,41,120,161,76,31,13,51,88,961,4
"586","2020-21","ATL","Playoffs","A","W",245,524,0.5,65,200,0.3,180,324,0.6,52,208,260,112,47,25,64,123,1439,6
"587","2020-21","ATL","Playoffs","A","L",144,339,0.4,47,148,0.3,97,191,0.5,38,122,160,74,21,26,63,86,964,4
"588","2020-21","IND","Regular Season","H","W",587,1168,0.5,155,405,0.4,432,763,0.6,110,429,539,362,115,88,159,269,3143,13
"589","2020-21","IND","Regular Season","H","L",927,2079,0.4,263,795,0.3,664,1284,0.5,200,757,957,560,190,142,308,493,5575,23
"590","2020-21","IND","Regular Season","A","W",975,1910,0.5,290,702,0.4,685,1208,0.6,199,781,980,640,178,160,275,409,5141,21
"591","2020-21","IND","Regular Season","A","L",626,1410,0.4,181,543,0.3,445,867,0.5,139,457,596,411,128,70,195,282,3599,15
"592","2020-21","BKN","Regular Season","H","W",1232,2418,0.5,404,973,0.4,828,1445,0.6,228,1034,1262,794,202,162,364,536,6725,28
"593","2020-21","BKN","Regular Season","H","L",308,693,0.4,94,299,0.3,214,394,0.5,78,282,360,184,49,46,133,151,1947,8
"594","2020-21","BKN","Regular Season","A","W",907,1748,0.5,305,732,0.4,602,1016,0.6,195,704,899,569,131,96,229,389,4849,20
"595","2020-21","BKN","Regular Season","A","L",659,1430,0.5,217,596,0.4,442,834,0.5,139,539,678,382,102,75,218,295,3889,16
"596","2020-21","BKN","Playoffs","H","W",257,525,0.5,92,228,0.4,165,297,0.6,50,210,260,154,39,34,58,123,1435,6
"597","2020-21","BKN","Playoffs","H","L",39,84,0.5,12,39,0.3,27,45,0.6,11,35,46,23,4,3,13,20,265,1
"598","2020-21","BKN","Playoffs","A","W",48,83,0.6,16,27,0.6,32,56,0.6,9,27,36,29,8,9,9,28,240,1
"599","2020-21","BKN","Playoffs","A","L",144,342,0.4,43,133,0.3,101,209,0.5,29,140,169,65,34,12,49,83,961,4
"600","2020-21","DEN","Regular Season","H","W",1125,2246,0.5,334,859,0.4,791,1387,0.6,264,919,1183,718,212,129,325,484,6085,25
"601","2020-21","DEN","Regular Season","H","L",439,999,0.4,140,399,0.4,299,600,0.5,125,330,455,277,72,42,134,245,2694,11
"602","2020-21","DEN","Regular Season","A","W",974,1949,0.5,275,723,0.4,699,1226,0.6,235,779,1014,589,181,90,278,368,5354,22
"603","2020-21","DEN","Regular Season","A","L",576,1228,0.5,178,481,0.4,398,747,0.5,134,414,548,349,117,62,186,277,3364,14
"604","2020-21","DEN","Playoffs","H","W",96,190,0.5,32,72,0.4,64,118,0.5,23,64,87,62,17,8,23,49,530,2
"605","2020-21","DEN","Playoffs","H","L",131,286,0.5,39,114,0.3,92,172,0.5,36,95,131,65,13,13,30,63,721,3
"606","2020-21","DEN","Playoffs","A","W",83,170,0.5,35,72,0.5,48,98,0.5,22,62,84,52,12,7,25,36,478,2
"607","2020-21","DEN","Playoffs","A","L",111,276,0.4,41,127,0.3,70,149,0.5,36,98,134,70,19,15,29,56,719,3
"608","2020-21","UTA","Regular Season","H","W",1300,2708,0.5,544,1369,0.4,756,1339,0.6,325,1210,1535,766,205,167,421,568,7443,31
"609","2020-21","UTA","Regular Season","H","L",180,430,0.4,68,191,0.4,112,239,0.5,62,182,244,91,28,19,75,101,1201,5
"610","2020-21","UTA","Regular Season","A","W",892,1826,0.5,361,867,0.4,531,959,0.6,218,830,1048,528,134,120,287,363,5038,21
"611","2020-21","UTA","Regular Season","A","L",599,1380,0.4,232,671,0.3,367,709,0.5,160,487,647,318,107,65,190,303,3678,15
"612","2020-21","UTA","Playoffs","H","W",177,352,0.5,73,172,0.4,104,180,0.6,37,138,175,88,21,18,47,88,959,4
"613","2020-21","UTA","Playoffs","H","L",70,161,0.4,32,101,0.3,38,60,0.6,19,67,86,35,10,12,27,42,480,2
"614","2020-21","UTA","Playoffs","A","W",79,166,0.5,36,77,0.5,43,89,0.5,14,71,85,40,11,11,24,34,482,2
"615","2020-21","UTA","Playoffs","A","L",111,247,0.4,57,130,0.4,54,117,0.5,33,87,120,53,15,4,39,73,719,3
"616","2020-21","CHA","Regular Season","H","W",746,1572,0.5,279,681,0.4,467,891,0.5,178,663,841,508,129,100,246,337,4321,18
"617","2020-21","CHA","Regular Season","H","L",695,1595,0.4,217,654,0.3,478,941,0.5,203,575,778,453,135,76,263,316,4345,18
"618","2020-21","CHA","Regular Season","A","W",625,1335,0.5,212,554,0.4,413,781,0.5,164,530,694,421,123,83,200,285,3630,15
"619","2020-21","CHA","Regular Season","A","L",809,1822,0.4,277,777,0.4,532,1045,0.5,217,621,838,551,178,85,312,360,5064,21
"620","2020-21","DET","Regular Season","H","W",525,1090,0.5,162,410,0.4,363,680,0.5,123,459,582,325,106,70,194,259,3149,13
"621","2020-21","DET","Regular Season","H","L",826,1925,0.4,239,729,0.3,587,1196,0.5,215,748,963,507,158,121,325,462,5572,23
"622","2020-21","DET","Regular Season","A","W",299,613,0.5,98,239,0.4,201,374,0.5,68,255,323,206,57,42,93,156,1680,7
"623","2020-21","DET","Regular Season","A","L",1133,2534,0.4,333,992,0.3,800,1542,0.5,288,919,1207,705,210,138,408,600,7034,29
"624","2020-21","MIA","Regular Season","H","W",839,1722,0.5,290,741,0.4,549,981,0.6,190,720,910,570,161,84,301,405,5035,21
"625","2020-21","MIA","Regular Season","H","L",563,1255,0.4,187,545,0.3,376,710,0.5,118,470,588,377,112,67,193,264,3649,15
"626","2020-21","MIA","Regular Season","A","W",773,1590,0.5,252,676,0.4,521,914,0.6,147,676,823,521,154,72,227,352,4557,19
"627","2020-21","MIA","Regular Season","A","L",649,1462,0.4,203,644,0.3,446,818,0.5,124,543,667,427,142,63,235,342,4138,17
"628","2020-21","MIA","Playoffs","H","L",72,176,0.4,20,65,0.3,52,111,0.5,15,67,82,44,15,9,27,46,478,2
"629","2020-21","MIA","Playoffs","A","L",69,181,0.4,28,78,0.4,41,103,0.4,21,66,87,42,14,5,28,36,506,2
"630","2020-21","ORL","Regular Season","H","W",450,952,0.5,155,364,0.4,295,588,0.5,103,415,518,268,84,53,155,206,2641,11
"631","2020-21","ORL","Regular Season","H","L",947,2262,0.4,276,805,0.3,671,1457,0.5,267,821,1088,548,156,111,310,413,6002,25
"632","2020-21","ORL","Regular Season","A","W",431,919,0.5,94,264,0.4,337,655,0.5,115,361,476,246,89,46,105,177,2427,10
"633","2020-21","ORL","Regular Season","A","L",926,2290,0.4,259,855,0.3,667,1435,0.5,262,928,1190,509,167,108,312,441,6267,26
"634","2020-21","MIL","Regular Season","H","W",1210,2381,0.5,418,982,0.4,792,1399,0.6,267,1054,1321,708,194,133,352,435,6248,26
"635","2020-21","MIL","Regular Season","H","L",407,912,0.4,131,383,0.3,276,529,0.5,111,354,465,229,72,38,147,159,2419,10
"636","2020-21","MIL","Regular Season","A","W",920,1848,0.5,283,724,0.4,637,1124,0.6,205,798,1003,544,191,93,281,353,4821,20
"637","2020-21","MIL","Regular Season","A","L",684,1469,0.5,206,580,0.4,478,889,0.5,158,518,676,353,128,70,184,297,3844,16
"638","2020-21","MIL","Playoffs","H","W",415,910,0.5,107,357,0.3,308,553,0.6,133,383,516,233,98,46,122,180,2427,10
"639","2020-21","MIL","Playoffs","H","L",47,102,0.5,8,36,0.2,39,66,0.6,12,33,45,27,6,4,8,14,241,1
"640","2020-21","MIL","Playoffs","A","W",268,550,0.5,83,216,0.4,185,334,0.6,81,211,292,151,46,24,69,115,1460,6
"641","2020-21","MIL","Playoffs","A","L",238,533,0.4,60,195,0.3,178,338,0.5,69,204,273,114,30,23,79,104,1438,6
"642","2020-21","POR","Regular Season","H","W",839,1798,0.5,331,832,0.4,508,966,0.5,216,716,932,408,135,107,220,365,4825,20
"643","2020-21","POR","Regular Season","H","L",626,1485,0.4,236,682,0.3,390,803,0.5,187,512,699,349,119,65,176,301,3843,16
"644","2020-21","POR","Regular Season","A","W",973,2017,0.5,370,858,0.4,603,1159,0.5,227,745,972,515,164,124,220,432,5282,22
"645","2020-21","POR","Regular Season","A","L",535,1258,0.4,195,567,0.3,340,691,0.5,136,468,604,259,78,67,159,264,3359,14
"646","2020-21","POR","Playoffs","H","W",42,84,0.5,12,33,0.4,30,51,0.6,4,40,44,24,6,7,6,21,239,1
"647","2020-21","POR","Playoffs","H","L",85,179,0.5,29,81,0.4,56,98,0.6,22,60,82,44,13,11,23,46,481,2
"648","2020-21","POR","Playoffs","A","W",43,91,0.5,19,40,0.5,24,51,0.5,10,29,39,29,3,2,6,14,240,1
"649","2020-21","POR","Playoffs","A","L",82,176,0.5,37,81,0.5,45,95,0.5,20,65,85,40,9,13,35,58,532,2
"650","2020-21","PHX","Regular Season","H","W",1202,2388,0.5,366,914,0.4,836,1474,0.6,253,976,1229,747,198,107,319,500,6513,27
"651","2020-21","PHX","Regular Season","H","L",377,807,0.5,121,342,0.4,256,465,0.6,77,317,394,228,64,35,123,193,2239,9
"652","2020-21","PHX","Regular Season","A","W",1072,2146,0.5,324,820,0.4,748,1326,0.6,187,805,992,688,172,113,267,428,5826,24
"653","2020-21","PHX","Regular Season","A","L",467,1016,0.5,129,414,0.3,338,602,0.6,113,364,477,276,83,57,155,253,2902,12
"654","2020-21","PHX","Playoffs","H","W",348,706,0.5,104,274,0.4,244,432,0.6,65,293,358,209,51,25,72,141,1918,8
"655","2020-21","PHX","Playoffs","H","L",119,242,0.5,30,71,0.4,89,171,0.5,19,88,107,66,19,9,35,62,721,3
"656","2020-21","PHX","Playoffs","A","W",245,504,0.5,69,169,0.4,176,335,0.5,55,228,283,135,42,33,71,119,1442,6
"657","2020-21","PHX","Playoffs","A","L",188,419,0.4,43,140,0.3,145,279,0.5,36,155,191,101,30,25,72,112,1198,5
"658","2020-21","SAS","Regular Season","H","W",613,1266,0.5,158,404,0.4,455,862,0.5,133,512,645,372,118,67,151,240,3360,14
"659","2020-21","SAS","Regular Season","H","L",890,1982,0.4,213,630,0.3,677,1352,0.5,200,748,948,516,130,118,260,396,5406,22
"660","2020-21","SAS","Regular Season","A","W",836,1723,0.5,198,537,0.4,638,1186,0.5,186,688,874,476,134,105,206,356,4616,19
"661","2020-21","SAS","Regular Season","A","L",675,1547,0.4,147,475,0.3,528,1072,0.5,150,541,691,395,123,76,174,301,4107,17
"662","2020-21","MIN","Regular Season","H","W",512,1134,0.5,181,486,0.4,331,648,0.5,133,461,594,344,111,60,159,245,3122,13
"663","2020-21","MIN","Regular Season","H","L",905,2089,0.4,284,860,0.3,621,1229,0.5,253,757,1010,584,197,141,334,487,5597,23
"664","2020-21","MIN","Regular Season","A","W",452,935,0.5,142,394,0.4,310,541,0.6,103,342,445,264,99,65,135,202,2401,10
"665","2020-21","MIN","Regular Season","A","L",1063,2388,0.4,337,966,0.3,726,1422,0.5,268,816,1084,654,225,132,355,573,6290,26
"666","2020-21","OKC","Regular Season","H","W",430,894,0.5,140,355,0.4,290,539,0.5,104,393,497,244,65,43,153,172,2424,10
"667","2020-21","OKC","Regular Season","H","L",989,2270,0.4,281,875,0.3,708,1395,0.5,264,898,1162,559,167,121,415,440,6242,26
"668","2020-21","OKC","Regular Season","A","W",488,1030,0.5,174,450,0.4,314,580,0.5,99,464,563,277,90,64,170,228,2880,12
"669","2020-21","OKC","Regular Season","A","L",888,2144,0.4,262,849,0.3,626,1295,0.5,248,813,1061,508,182,88,370,465,5816,24
"670","2020-21","NYK","Regular Season","H","W",1033,2157,0.5,311,752,0.4,722,1405,0.5,237,906,1143,554,184,131,287,506,6096,25
"671","2020-21","NYK","Regular Season","H","L",407,956,0.4,116,330,0.4,291,626,0.5,116,354,470,218,69,39,128,210,2661,11
"672","2020-21","NYK","Regular Season","A","W",673,1392,0.5,211,473,0.4,462,919,0.5,160,605,765,371,129,94,198,331,3843,16
"673","2020-21","NYK","Regular Season","A","L",726,1720,0.4,209,608,0.3,517,1112,0.5,183,689,872,398,125,101,263,426,4829,20
"674","2020-21","NYK","Playoffs","H","W",36,94,0.4,12,33,0.4,24,61,0.4,13,41,54,15,8,2,10,20,241,1
"675","2020-21","NYK","Playoffs","H","L",73,176,0.4,22,60,0.4,51,116,0.4,27,67,94,40,8,8,27,38,481,2
"676","2020-21","NYK","Playoffs","A","L",63,162,0.4,18,59,0.3,45,103,0.4,19,65,84,38,13,4,20,41,482,2
"677","2020-21","CHI","Regular Season","H","W",669,1313,0.5,209,532,0.4,460,781,0.6,130,545,675,414,106,66,210,272,3631,15
"678","2020-21","CHI","Regular Season","H","L",818,1857,0.4,261,727,0.4,557,1130,0.5,216,713,929,511,119,80,312,379,5045,21
"679","2020-21","CHI","Regular Season","A","W",707,1433,0.5,214,529,0.4,493,904,0.5,163,615,778,469,121,83,233,315,3871,16
"680","2020-21","CHI","Regular Season","A","L",841,1777,0.5,220,658,0.3,621,1119,0.6,184,671,855,533,136,75,290,396,4853,20
"681","2020-21","TOR","Regular Season","H","W",651,1395,0.5,246,633,0.4,405,762,0.5,151,585,736,410,129,103,215,320,3845,16
"682","2020-21","TOR","Regular Season","H","L",772,1813,0.4,262,787,0.3,510,1026,0.5,216,603,819,439,174,91,245,430,4825,20
"683","2020-21","TOR","Regular Season","A","W",477,965,0.5,180,408,0.4,297,557,0.5,101,372,473,284,105,63,143,218,2644,11
"684","2020-21","TOR","Regular Season","A","L",959,2210,0.4,353,1003,0.4,606,1207,0.5,212,754,966,602,210,131,295,558,6000,25
"685","2020-21","LAL","Regular Season","H","W",892,1810,0.5,225,638,0.4,667,1172,0.6,218,771,989,556,177,128,320,397,5189,21
"686","2020-21","LAL","Regular Season","H","L",588,1278,0.5,154,475,0.3,434,803,0.5,133,501,634,342,108,74,235,287,3625,15
"687","2020-21","LAL","Regular Season","A","W",884,1813,0.5,264,664,0.4,620,1149,0.5,205,755,960,533,180,118,301,393,5039,21
"688","2020-21","LAL","Regular Season","A","L",561,1296,0.4,153,471,0.3,408,825,0.5,139,463,602,344,97,66,204,300,3601,15
"689","2020-21","LAL","Playoffs","H","W",38,86,0.4,7,28,0.2,31,58,0.5,15,36,51,19,10,4,20,19,240,1
"690","2020-21","LAL","Playoffs","H","L",70,172,0.4,23,75,0.3,47,97,0.5,20,65,85,40,8,8,22,38,480,2
"691","2020-21","LAL","Playoffs","A","W",36,80,0.4,10,33,0.3,26,47,0.6,8,31,39,24,9,6,7,23,241,1
"692","2020-21","LAL","Playoffs","A","L",62,160,0.4,19,61,0.3,43,99,0.4,20,64,84,33,13,6,30,43,480,2
"693","2020-21","LAC","Regular Season","H","W",1150,2253,0.5,410,904,0.5,740,1349,0.5,224,926,1150,699,183,115,320,527,6240,26
"694","2020-21","LAC","Regular Season","H","L",375,858,0.4,113,329,0.3,262,529,0.5,105,350,455,216,51,37,125,175,2402,10
"695","2020-21","LAC","Regular Season","A","W",892,1794,0.5,304,720,0.4,588,1074,0.5,196,772,968,503,162,84,264,402,5048,21
"696","2020-21","LAC","Regular Season","A","L",592,1337,0.4,200,545,0.4,392,792,0.5,153,453,606,338,113,59,185,279,3595,15
"697","2020-21","LAC","Playoffs","H","W",212,415,0.5,86,189,0.5,126,226,0.6,48,156,204,117,46,22,44,94,1205,5
"698","2020-21","LAC","Playoffs","H","L",175,410,0.4,55,181,0.3,120,229,0.5,54,154,208,101,28,25,48,93,1200,5
"699","2020-21","LAC","Playoffs","A","W",204,394,0.5,62,168,0.4,142,226,0.6,32,181,213,95,37,18,52,98,1198,5
"700","2020-21","LAC","Playoffs","A","L",152,338,0.4,60,153,0.4,92,185,0.5,33,124,157,82,18,16,36,85,958,4
